Абаканська вулиця | Абаканская улица
Абаканський провулок | Абаканский переулок
Абразумівська вулиця | Абразумовская улица
Абрикосова вулиця | Абрикосовая улица
Авангардна вулиця | Авангардная улица
Авангардний провулок | Авангардный переулок
Аверіна провулок | Аверина переулок
Аверіна вулиця | Аверина улица
Авіахімічна вулиця | Авиахимическая улица
Авіахімічний провулок | Авиахимический переулок
Авіаційна вулиця | Авиационная улица
Аврамівська вулиця | Аврамовская улица
Автоґенна вулиця | Автогенная улица
Автоматний в'їзд | Автоматный въезд
Автоматний проїзд | Автоматный проезд
Автострадна вулиця | Автострадная улица
Автострадна набережна | Автострадная набережная
Автострадний провулок | Автострадный переулок
Автотракторна вулиця | Автотракторная улица
Автотракторний провулок | Автотракторный переулок
Автотракторний в'їзд | Автотракторный въезд
Автошляхова вулиця | Автодорожная улица
Автошляховий в'їзд | Автодорожный въезд
Аграрна вулиця | Аграрная улица
Агрономічна вулиця | Агрономическая улица
Аджарський провулок | Аджарский переулок
Адиґейська вулиця | Адыгейская улица
Адиґейський провулок | Адыгейский переулок
Аеродромна вулиця | Аэродромная улица
Аеродромний провулок | Аэродромный переулок
Аеропортна вулиця | Аэропортная улица
Аеропортний провулок | Аэропортный переулок
Аеропортний в'їзд | Аэропортный въезд
Аерофлотська вулиця | Аэрофлотская улица
Азербайджанська вулиця | Азербайджанская улица
Азербайджанський проїзд | Азербайджанский проезд
Азербайджанський в'їзд | Азербайджанский въезд
Азовстальська вулиця | Азовстальская улица
Азовська вулиця | Азовская улица
Азовський провулок | Азовский переулок
Айвазовського вулиця | Айвазовского улица
Айвазовського 1-й провулок | Айвазовского 1-й переулок
Айвазовського 2-й провулок | Айвазовского 2-й переулок
Академіка Богомольця вулиця | Академика Богомольца улица
Академіка Вальтера вулиця | Академика Вальтера улица
Академіка Вєркіна вулиця | Академика Веркина улица
Академіка Волкова вулиця | Академика Волкова улица
Академіка Курчатова проспект | Академика Курчатова проспект
Академіка Павлова провулок | Академика Павлова переулок
Академіка Павлова вулиця | Академика Павлова улица
Академіка Павлова в'їзд | Академика Павлова въезд
Академіка Підгорного провулок | Академика Подгорного переулок
Академіка Підгорного вулиця | Академика Подгорного улица
Академіка Погорєлова вулиця | Академика Погорелова улица
Академіка Проскури вулиця | Академика Проскуры улица
Академіка Сергєєва вулиця | Академика Сергеева улица
Академіка Синельникова вулиця | Академика Синельникова улица
Академіка Філіппова вулиця | Академика Филиппова улица
Академічна вулиця | Академическая улица
Аксакова провулок | Аксакова переулок
Актюбінська вулиця | Актюбинская улица
Алексєєва Петра вулиця | Алексеева Петра улица
Алмазна вулиця | Алмазная улица
Алматинська вулиця | Алматинская улица
Алматинський провулок | Алматинский переулок
Алтайський провулок | Алтайский переулок
Алупкінська вулиця | Алупкинская улица
Алуштинська вулиця | Алуштинская улица
Алуштинський провулок | Алуштинский переулок
Алуштинський узвіз | Алуштинский спуск
Алчевських вулиця | Алчевских улица
Альбівський провулок | Альбовский переулок
Аляб'єва провулок | Алябьева переулок
Амосова вулиця | Амосова улица
Амурська вулиця | Амурская улица
Амурський провулок | Амурский переулок
Анадирська вулиця | Анадырская улица
Анадирський провулок | Анадырский переулок
Анапська вулиця | Анапская улица
Ангарська вулиця | Ангарская улица
Ангарський провулок | Ангарский переулок
Андріївська вулиця | Андреевская улица
Андріївський провулок | Андреевский переулок
Антокольського вулиця | Антокольского улица
Аптекарський в'їзд | Аптекарский въезд
Аптекарський провулок | Аптекарский переулок
Аравійська вулиця | Аравийская улица
Аравійський провулок | Аравийский переулок
Аравійський 1-й в'їзд | Аравийский 1-й въезд
Аравійський 2-й в'їзд | Аравийский 2-й въезд
Аральська вулиця | Аральская улица
Аральський в'їзд | Аральский въезд
Аральський провулок | Аральский переулок
Арктична вулиця | Арктическая улица
Арктичний провулок | Арктический переулок
Арматурна вулиця | Арматурная улица
Арматурний провулок | Арматурный переулок
Армійська вулиця | Армейская улица
Армійський в'їзд | Армейский въезд
Арсенальна вулиця | Арсенальная улица
Артамонівська вулиця | Артамоновская улица
Артема Веделя вулиця | Артема Веделя улица
Артилерійська вулиця | Артиллерийская улица
Артилерійський провулок | Артиллерийский переулок
Артільна вулиця | Артельная улица
Артільний провулок | Артельный переулок
Артюхівська вулиця | Артюховская улица
Артюхівський провулок | Артюховский переулок
Архангельська вулиця | Архангельская улица
Архангельський провулок | Архангельский переулок
Архангельський в'їзд | Архангельский въезд
Архітектора Альошина проспект | Архитектора Алешина проспект
Архітекторів майдан | Архитекторов площадь
Архітекторів вулиця | Архитекторов улица
Аскольдівська вулиця | Аскольдовская улица
Аскольдівський в'їзд | Аскольдовский въезд
Аскольдівський 1-й в'їзд | Аскольдовский 1-й въезд
Астраханська вулиця | Астраханская улица
Астрономічна вулиця | Астрономическая улица
Астрономічний в'їзд | Астрономический въезд
Афанасівська вулиця | Афанасьевская улица
Афанасівський провулок | Афанасьевский переулок
Ахієзерів вулиця | Ахиезеров улица
Ахматової вулиця | Ахматовой улица
Ахсарова вулиця | Ахсарова улица
Ашгабатська вулиця | Ашхабадская улица
Ашгабатський провулок | Ашхабадский переулок
Бабаївська вулиця | Бабаевская улица
Баварська вулиця | Баварская улица
Баварський провулок | Баварский переулок
Багалія вулиця | Багалея улица
Багратіона провулок | Багратиона переулок
Багратіона вулиця | Багратиона улица
Багратіона в'їзд | Багратиона въезд
Бажова провулок | Бажова переулок
Базарна вулиця | Базарная улица
Базарний майдан | Базарная площадь
Байдарська вулиця | Байдарская улица
Байкальська вулиця | Байкальская улица
Байкальський провулок | Байкальский переулок
Байрона провулок | Байрона переулок
Байрона 1-й в'їзд | Байрона 1-й въезд
Байрона 2-й в'їзд | Байрона 2-й въезд
Бакинська вулиця | Бакинская улица
Бакуліна вулиця | Бакулина улица
Бакуніна провулок | Бакунина переулок
Бакуніна вулиця | Бакунина улица
Балавенського провулок | Балавенского переулок
Балавенського вулиця | Балавенского улица
Балакірєва в'їзд | Балакирева въезд
Балакірєва вулиця | Балакирева улица
Балакірєва провулок | Балакирева переулок
Балаклавський провулок | Балаклавский переулок
Балаклійська вулиця | Балаклейская улица
Балаклійський провулок | Балаклейский переулок
Балаклійський в'їзд | Балаклейский въезд
Балашовська вулиця | Балашовская улица
Балашовський провулок | Балашовский переулок
Балашовський проїзд | Балашовский проезд
Балашовський провулок | Балашовский переулок
Балканська вулиця | Балканская улица
Балтійська вулиця | Балтийская улица
Балхаська вулиця | Балхашская улица
Балхаський провулок | Балхашский переулок
Банківський провулок | Банковский переулок
Банний провулок | Банный переулок
Барабашова вулиця | Барабашова улица
Барвінківська вулиця | Барвенковская улица
Барвінківський провулок | Барвенковский переулок
Барикадна вулиця | Баррикадная улица
Барикадний провулок | Баррикадный переулок
Баркалова вулиця | Баркалова улица
Барнаульська вулиця | Барнаульская улица
Басейна вулиця | Бассейная улица
Басейний 1-й провулок | Бассейный 1-й переулок
Басейний 2-й провулок | Бассейный 2-й переулок
Батайська вулиця | Батайская улица
Батайський провулок | Батайский переулок
Батумська вулиця | Батумская улица
Батумський провулок | Батумский переулок
Батуринська вулиця | Батуринская улица
Башкирська вулиця | Башкирская улица
Башкирський провулок | Башкирский переулок
Башлаївський провулок | Башлаевский переулок
Безіменна вулиця | Безымянная улица
Безкрайня вулиця | Бескрайняя улица
Безлюдівська вулиця | Безлюдовская улица
Безпалівський провулок | Беспаловский переулок
Безпалівський в'їзд | Беспаловский въезд
Безперчого провулок | Бесперчего переулок
Безперчого вулиця | Бесперчего улица
Безперчого в'їзд | Бесперчего въезд
Бекетова вулиця | Бекетова улица
Берегова вулиця | Береговая улица
Березівська вулиця | Березовская улица
Березівський в'їзд | Березовский въезд
Березнева вулиця | Березневая улица
Берестова вулиця | Берестовая улица
Берзиня вулиця | Берзиня улица
Берінговий провулок | Беринговый переулок
Беркоса вулиця | Беркоса улица
Беркоса в'їзд | Беркоса въезд
Бессарабська вулиця | Бессарабская улица
Бестужева провулок | Бестужева переулок
Бестужева в'їзд | Бестужева въезд
Бестужева вулиця | Бестужева улица
Бетховена провулок | Бетховена переулок
Бехтерєва провулок | Бехтерева переулок
Бєлінського вулиця | Белинского улица
Бєлінського провулок | Белинского переулок
Бирюківський провулок | Бирюковский переулок
Біблика вулиця | Библика улица
Білгородське шосе | Белгородское шоссе
Білгородський узвіз | Белгородский спуск
Білецького вулиця | Белецкого улица
Білобровський провулок | Белобровский переулок
Біловезька вулиця | Беловежская улица
Білогорська вулиця | Белогорская улица
Білої Акації вулиця | Белой Акации улица
Біломорська вулиця | Беломорская улица
Білоруська вулиця | Белорусская улица
Білостоцький в'їзд | Белостокский въезд
Білостоцький провулок | Белостокский переулок
Біологічна вулиця | Биологическая улица
Біологічний в'їзд | Биологический въезд
Біологічний провулок | Биологический переулок
Біробіджанський 2-й проїзд | Биробиджанский 2-й проезд
Біробіджанський 3-й проїзд | Биробиджанский 3-й проезд
Біробіджанський 4-й проїзд | Биробиджанский 4-й проезд
Благовіщенська вулиця | Благовещенская улица
Благовіщенський майдан | Благовещенская площадь
Благодатна вулиця | Благодатная улица
Блакитного вулиця | Блакитного улица
Близнюківська вулиця | Близнюковская улица
Блискучий провулок | Блискучий переулок
Бобруйська вулиця | Бобруйская улица
Богдана Хмельницького бульвар | Богдана Хмельницкого бульвар
Богдана Хмельницького вулиця | Богдана Хмельницкого улица
Богодухівська вулиця | Богодуховская улица
Бойова вулиця | Боевая улица
Бойовий 1-й провулок | Боевой 1-й переулок
Бойовий 2-й провулок | Боевой 2-й переулок
Бокаріуса провулок | Бокариуса переулок
Болгарська вулиця | Болгарская улица
Болгарський провулок | Болгарский переулок
Болонська вулиця | Болонская улица
Бондаренка провулок | Бондаренко переулок
Бондаренківська вулиця | Бондаренковская улица
Бондарівська вулиця | Бондаревская улица
Бондарівський провулок | Бондаревский переулок
Борзенка вулиця | Борзенко улица
Борзий провулок | Борзый переулок
Бориса Шрамка вулиця | Бориса Шрамко улица
Борисівська вулиця | Борисовская улица
Борисоглібська вулиця | Борисоглебская улица
Борова вулиця | Боровая улица
Бородинівська вулиця | Бородиновская улица
Бородівський в'їзд | Бородивский въезд
Бородіна вулиця | Бородина улица
Боротьби вулиця | Борьбы улица
Борткевича провулок | Борткевича переулок
Борткевича вулиця | Борткевича улица
Борщівський провулок | Борщевский переулок
Босенківська вулиця | Босенковская улица
Ботанічна набережна | Ботаническая набережная
Ботанічна вулиця | Ботаническая улица
Ботанічний провулок | Ботанический переулок
Боткіна в'їзд | Боткина въезд
Боткіна провулок | Боткина переулок
Бочанський проїзд | Бочанский проезд
Бочанський 1-й в'їзд | Бочанский 1-й въезд
Бочанський 1-й провулок | Бочанский 1-й переулок
Бочанський 2-й в'їзд | Бочанский 2-й въезд
Бочанський 2-й провулок | Бочанский 2-й переулок
Бочанський 3-й провулок | Бочанский 3-й переулок
Бочанський 4-й провулок | Бочанский 4-й переулок
Бочанський 5-й провулок | Бочанский 5-й переулок
Бочарівський провулок | Бочаривский переулок
Бражниківська вулиця | Бражниковская улица
Братська вулиця | Братская улица
Братський в'їзд | Братский въезд
Братський 1-й проїзд | Братский 1-й проезд
Братський 2-й проїзд | Братский 2-й проезд
Брестська вулиця | Брестская улица
Брестський провулок | Брестский переулок
Бригадна вулиця | Бригадная улица
Бригадний в'їзд | Бригадный въезд
Броненосця Потьомкін вулиця | Броненосца Потемкин улица
Броньова вулиця | Броневая улица
Броньовий провулок | Броневой переулок
Брюсова вулиця | Брюсова улица
Брянський провулок | Брянский переулок
Бугрименка проїзд | Бугрименко проезд
Бугрименка вулиця | Бугрименко улица
Бугрименка 1-й в'їзд | Бугрименко 1-й въезд
Бугрименка 2-й в'їзд | Бугрименко 2-й въезд
Бугримової майдан | Бугримовой площадь
Бугурусланський провулок | Бугурусланский переулок
Будівельна вулиця | Строительная улица
Будівельний провулок | Строительный переулок
Будівельний 1-й в'їзд | Строительный 1-й въезд
Будівельний 2-й в'їзд | Строительный 2-й въезд
Будівельний 3-й в'їзд | Строительный 3-й въезд
Будянський провулок | Будянский переулок
Бужинський провулок | Бужинский переулок
Бузескула вулиця | Бузескула улица
Бузкова вулиця | Бузковая улица
Бузковий провулок | Сиреневый переулок
Букова вулиця | Буковая улица
Буковий в'їзд | Буковый въезд
Буковий провулок | Буковый переулок
Буковинська вулиця | Буковинская улица
Буковинський провулок | Буковинский переулок
Бульварна вулиця | Бульварная улица
Бурачека вулиця | Бурачека улица
Бурлацький провулок | Бурлацкий переулок
Бурсацька набережна | Бурсацкая набережная
Бурсацький узвіз | Бурсацкий спуск
Бутівський в'їзд | Бутовский въезд
Бутлерівська вулиця | Бутлеровская улица
Бучми вулиця | Бучмы улица
Вавилова вулиця | Вавилова улица
Вагнера вулиця | Вагнера улица
Вагонна вулиця | Вагонная улица
Вакулівська вулиця | Вакуловская улица
Валдайська вулиця | Валдайская улица
Валдайський провулок | Валдайский переулок
Валентинівська вулиця | Валентиновская улица
Валерія Петросова вулиця | Валерия Петросова улица
Валер'янівська вулиця | Валерьяновская улица
Валер'янівський провулок | Валерьяновский переулок
Валківський провулок | Валковский переулок
Ванди Биневської провулок | Ванды Биневской переулок
Варварівська вулиця | Варваровская улица
Варениківський провулок | Варениковский переулок
Варламівський провулок | Варламовский переулок
Варненська вулиця | Варненская улица
Варшавський провулок | Варшавский переулок
Васильєва в'їзд | Васильева въезд
Васильєва вулиця | Васильева улица
Васильєва провулок | Васильева переулок
Васильківський провулок | Васильковский переулок
Васильківського вулиця | Васильковского улица
Василя Мельникова вулиця | Василия Мельникова улица
Василя Стуса вулиця | Василия Стуса улица
Васищевська вулиця | Васищевская улица
Васнецова вулиця | Васнецова улица
Васнецова проїзд | Васнецова проезд
Васнецова 1-й провулок | Васнецова 1-й переулок
Васнецова 2-й провулок | Васнецова 2-й переулок
Ватутіна провулок | Ватутина переулок
Ватутіна вулиця | Ватутина улица
Ващенківський провулок | Ващенковский переулок
Ващенківський в'їзд | Ващенковский въезд
Велика Гончарівська вулиця | Большая Гончаровская улица
Велика Данилівська вулиця | Большая Даниловская улица
Велика Жихорська вулиця | Большая Жихорская улица
Велика Кільцева вулиця | Большая Кольцевая улица
Велика Панасівська вулиця | Большая Панасовская улица
Великий Данилівський провулок | Большой Даниловский переулок
Велико-Бурлуцька вулиця | Велико-Бурлукская улица
Велишевська вулиця | Велишевская улица
Велишевський провулок | Велишевский переулок
Велозаводська вулиця | Велозаводская улица
Велозаводський провулок | Велозаводский переулок
Велозаводський проїзд | Велозаводский проезд
Венгеровського вулиця | Венгеровского улица
Вербицька вулиця | Вербицкая улица
Вербна вулиця | Вербная улица
Вербний 1-й провулок | Вербный 1-й переулок
Вербний 2-й провулок | Вербный 2-й переулок
Вербний 3-й провулок | Вербный 3-й переулок
Вербова вулиця | Вербовая улица
Вересова вулиця | Вересковая улица
Верещагіна вулиця | Верещагина улица
Верещаківський проїзд | Верещаковский проезд
Вернадського вулиця | Вернадского улица
Верстатна вулиця | Станковая улица
Верстатний провулок | Станковый переулок
Верстатний 1-й в'їзд | Станковый 1-й въезд
Верстатний 2-й в'їзд | Станковый 2-й въезд
Верстатний 3-й в'їзд | Станковый 3-й въезд
Верстатний 4-й в'їзд | Станковый 4-й въезд
Верстатобудівна вулиця | Станкостроительная улица
Верхівський провулок | Верховский переулок
Верхнєудінська вулиця | Верхнеудинская улица
Верхнєудінський провулок | Верхнеудинский переулок
Верхній провулок | Верхний переулок
Верхній в'їзд | Верхний въезд
Верхній 1-й проїзд | Верхний 1-й проезд
Верхньогиївський в'їзд | Верхнегиевский въезд
Верхня Гиївська вулиця | Верхнегиевская улица
Верхоянська вулиця | Верхоянская улица
Весела вулиця | Веселая улица
Веселий провулок | Веселый переулок
Весніна вулиця | Веснина улица
Весняна вулиця | Весняная улица
Весняний провулок | Весняный переулок
Весняний в'їзд | Весняный въезд
Вешенська вулиця | Вешенская улица
Вешенський провулок | Вешенский переулок
Вешенський в'їзд | Вешенский въезд
Виборзький провулок | Выборгский переулок
Виборна вулиця | Выборная улица
Виборний провулок | Выборный переулок
Виконкомівська вулиця | Исполкомовская улица
Виконкомівський в'їзд | Исполкомовский въезд
Виконкомівський провулок | Исполкомовский переулок
Винахідницький провулок | Изобретательский переулок
Винниченка вулиця | Винниченко улица
Виноградна вулиця | Виноградная улица
Виноградний провулок | Виноградный переулок
Виробнича вулиця | Выробнича улица
Високовольтна вулиця | Высоковольтная улица
Високовольтний проїзд | Высоковольтный проезд
Високовольтний провулок | Высоковольтный переулок
Високовольтний 1-й в'їзд | Высоковольтный 1-й въезд
Високовольтний 2-й в'їзд | Высоковольтный 2-й въезд
Високогірна вулиця | Высокогорная улица
Високогірний провулок | Высокогорный переулок
Високогірний проїзд | Высокогорный проезд
Високогірний 1-й проїзд | Высокогорный 1-й проезд
Високогірний 2-й проїзд | Высокогорный 2-й проезд
Високогірний 3-й проїзд | Высокогорный 3-й проезд
Високогірний 4-й проїзд | Высокогорный 4-й проезд
Височинська вулиця | Высочинская улица
Вишнева вулиця | Вишневая улица
Вишневий в'їзд | Вишневый въезд
Вишневий провулок | Вишневый переулок
Вівсяний провулок | Овсяный переулок
Відрадна вулиця | Отрадная улица
Відрадненський проїзд | Отрадненский проезд
Відрадний провулок | Отрадный переулок
Відрадний 1-й провулок | Отрадный 1-й переулок
Відрадний 2-й провулок | Отрадный 2-й переулок
Відродження вулиця | Возрождения улица
Відродження провулок | Возрождения переулок
Військова вулиця | Военная улица
Віктора Афанасьєва вулиця | Виктора Афанасьева улица
Віленський провулок | Виленский переулок
Вільна вулиця | Свободная улица
Вільхівська вулиця | Ольховская улица
Вільхівський провулок | Ольховский переулок
Вінницький провулок | Винницкий переулок
Віражна вулиця | Виражная улица
Віринська вулиця | Веринская улица
Вірменський провулок | Армянский переулок
Вітебська вулиця | Витебская улица
Владивостоцька вулиця | Владивостокская улица
Владивостоцький в'їзд | Владивостокский въезд
Владивостоцький провулок | Владивостокский переулок
Владислава Зубенка вулиця | Владислава Зубенко улица
Власенка вулиця | Власенко улица
Власівський провулок | Власовский переулок
Внуківський провулок | Внуковский переулок
Вовчанська вулиця | Волчанская улица
Водогінна вулиця | Водопроводная улица
Водолазька вулиця | Водолажская улица
Вокзальна вулиця | Вокзальная улица
Волгодонський провулок | Волгодонский переулок
Волзька вулиця | Волжская улица
Волинська вулиця | Волынская улица
Волинський провулок | Волынский переулок
Вологодська вулиця | Вологодская улица
Вологодський в'їзд | Вологодский въезд
Вологодський провулок | Вологодский переулок
Вологодський 2-й в'їзд | Вологодский 2-й въезд
Володимира Рідченка в'їзд | Владимира Ридченко въезд
Володимира Сосюри провулок | Владимира Сосюры переулок
Володимира Сосюри вулиця | Владимира Сосюры улица
Володимира Усенка провулок | Владимира Усенко переулок
Володимира Шестопалова провулок | Владимира Шестопалова переулок
Володимирська вулиця | Владимирская улица
Воложанівська вулиця | Воложановская улица
Волоколамський провулок | Волоколамский переулок
Волонтерська вулиця | Волонтерская улица
Волосна вулиця | Волостная улица
Волосний провулок | Волостной переулок
Волочаївська вулиця | Волочаевская улица
Волошинський провулок | Волошинский переулок
Волошкова вулиця | Волошковая улица
Волховська вулиця | Волховская улица
Воробйова провулок | Воробьева переулок
Воробйова вулиця | Воробьева улица
Вороніхіна вулиця | Воронихина улица
Вороніхіна провулок | Воронихина переулок
Воскобійницька вулиця | Воскобойницкая улица
Воскобійницький провулок | Воскобойницкий переулок
Воскобійницький проїзд | Воскобойницкий проезд
Воскресенська вулиця | Воскресенская улица
Воскресенський провулок | Воскресенский переулок
Восьмого Березня вулиця | Восьмого Марта улица
Врубеля вулиця | Врубеля улица
В'ялівський провулок | Вяловский переулок
Вятська вулиця | Вятская улица
В'ячеслава Чорновола вулиця | Вячеслава Черновола улица
Гагаріна вулиця | Гагарина улица
Гагаріна проспект | Гагарина проспект
Гагаріна провулок | Гагарина переулок
Гагена вулиця | Гагена улица
Галинська вулиця | Галинская улица
Галушкинська вулиця | Галушкинская улица
Гаражна вулиця | Гаражная улица
Гарібальді вулиця | Гарибальди улица
Гаркуші Іллі вулиця | Гаркуши Ильи улица
Гарнізонна вулиця | Гарнизонная улица
Гаршина вулиця | Гаршина улица
Гастелло вулиця | Гастелло улица
Гацева вулиця | Гацева улица
Гвардійська вулиця | Гвардейская улица
Гвардійський проїзд | Гвардейский проезд
Гвардійський провулок | Гвардейский переулок
Гвардійців-Залізничників вулиця | Гвардейцев-Железнодорожников улица
Гвардійців-Широнінців вулиця | Гвардейцев-Широнинцев улица
Генерала Момота вулиця | Генерала Момота улица
Генерала Удовиченка вулиця | Генерала Удовиченко улица
Генічеська вулиця | Геническая улица
Георгіївська вулиця | Георгиевская улица
Георгіївський майдан | Георгиевская площадь
Георгіївський 1-й в'їзд | Георгиевский 1-й въезд
Георгіївський 1-й провулок | Георгиевский 1-й переулок
Георгіївський 2-й провулок | Георгиевский 2-й переулок
Георгіївський 2-й в'їзд | Георгиевский 2-й въезд
Георгіївський 3-й в'їзд | Георгиевский 3-й въезд
Георгіївський 4-й в'їзд | Георгиевский 4-й въезд
Герасимівська вулиця | Герасимовская улица
Герасимівський провулок | Герасимовский переулок
Героїв Небесної Сотні майдан | Героев Небесной Сотни площадь
Героїв Праці вулиця | Героев Труда улица
Героїв Сталінграда проспект | Героев Сталинграда проспект
Героїв Чорнобиля майдан | Героев Чернобыля площадь
Герцена вулиця | Герцена улица
Герцена провулок | Герцена переулок
Гетьманська вулиця | Гетманская улица
Гиївська вулиця | Гиевская улица
Гідропаркова вулиця | Гидропарковая улица
Гімназійна набережна | Гимназическая набережная
Гірська вулиця | Горная улица
Гірський в'їзд | Горный въезд
Гірський провулок | Горный переулок
Гірський проїзд | Горный проезд
Гіршмана вулиця | Гиршмана улица
Гладкий провулок | Гладкий переулок
Гладківський провулок | Гладковский переулок
Глазунова провулок | Глазунова переулок
Глібівська вулиця | Глебовская улица
Глінки вулиця | Глинки улица
Глухий провулок | Глухой переулок
Гмирі вулиця | Гмыри улица
Гната Хоткевича вулиця | Гната Хоткевича улица
Гнєдича провулок | Гнедича переулок
Гоголя вулиця | Гоголя улица
Головачова в'їзд | Головачева въезд
Головинський провулок | Головинский переулок
Голубівська вулиця | Голубовская улица
Голубівський в'їзд | Голубовский въезд
Голубівський провулок | Голубовский переулок
Гольдбергівська вулиця | Гольдберговская улица
Гомельська вулиця | Гомельская улица
Гомоненка вулиця | Гомоненко улица
Гончаренка вулиця | Гончаренко улица
Гончарівський провулок | Гончаровский переулок
Гончарний провулок | Гончарный переулок
Горбанівська вулиця | Горбаневская улица
Горбанівський провулок | Горбаневский переулок
Горбанівський в'їзд | Горбаневский въезд
Гордієнківська вулиця | Гордиенковская улица
Гордієнківський провулок | Гордиенковский переулок
Гордона вулиця | Гордона улица
Горійська вулиця | Горийская улица
Горлівська вулиця | Горловская улица
Горлівський провулок | Горловский переулок
Горобинова вулиця | Рябиновая улица
Городищенська вулиця | Городищенская улица
Городищенський проїзд | Городищенский проезд
Городовикова вулиця | Городовикова улица
Гороховської вулиця | Гороховской улица
Горького в'їзд | Горького въезд
Горького вулиця | Горького улица
Горького 1-й провулок | Горького 1-й переулок
Горького 2-й провулок | Горького 2-й переулок
Горяївська вулиця | Горяевская улица
Горяївський провулок | Горяевский переулок
Горянська вулиця | Горянская улица
Горянський провулок | Горянский переулок
Господарська вулиця | Хозяйственная улица
Гостинна вулиця | Гостиная улица
Готнянський провулок | Готнянский переулок
Готнянський в'їзд | Готнянский въезд
Грабовського провулок | Грабовского переулок
Грайворонська вулиця | Грайворонская улица
Граківська вулиця | Граковская улица
Граківський проїзд | Граковский проезд
Гранівський проїзд | Грановский проезд
Гранітна вулиця | Гранитная улица
Гребенюківська вулиця | Гребенюковская улица
Греківська вулиця | Грековская улица
Гречаний провулок | Гречаный переулок
Грибна вулиця | Грибная улица
Грибний 1-й провулок | Грибной 1-й переулок
Грибний 2-й провулок | Грибной 2-й переулок
Грибоєдова в'їзд | Грибоедова въезд
Грибоєдова провулок | Грибоедова переулок
Грибоєдова вулиця | Грибоедова улица
Григорівська вулиця | Григоровская улица
Григорівське шосе | Григоровское шоссе
Гризодубова вулиця | Гризодубова улица
Грицевця бульвар | Грицевца бульвар
Грицевця вулиця | Грицевца улица
Грищенка вулиця | Грищенко улица
Грищенка провулок | Грищенко переулок
Грінченка вулиця | Гринченко улица
Грозненська вулиця | Грозненская улица
Громадянська вулиця | Гражданская улица
Громадянський провулок | Гражданский переулок
Громової Уляни вулиця | Громовой Ульяны улица
Грузинська вулиця | Грузинская улица
Грушева вулиця | Грушевая улица
Грушевського вулиця | Грушевского улица
Губенка вулиця | Губенко улица
Гуданова вулиця | Гуданова улица
Гуківська вулиця | Гуковская улица
Гуківський проїзд | Гуковский проезд
Гуківський в'їзд | Гуковский въезд
Гулака-Артемовського вулиця | Гулака-Артемовского улица
Гумілевського вулиця | Гумилевского улица
Гур'євська вулиця | Гурьевская улица
Гур'євський провулок | Гурьевский переулок
Гур'євський проїзд | Гурьевский проезд
Гурзуфська вулиця | Гурзуфская улица
Гуртовий провулок | Гуртовой переулок
Гутянська вулиця | Гутянская улица
Гутянський провулок | Гутянский переулок
Гюґо вулиця | Гюго улица
Дагестанська вулиця | Дагестанская улица
Дагестанський провулок | Дагестанский переулок
Далекосхідний провулок | Дальневосточный переулок
Дальній провулок | Дальний переулок
Данилевського вулиця | Данилевского улица
Даниленка вулиця | Даниленко улица
Данилівський узвіз | Даниловский спуск
Данилівський 1-й проїзд | Даниловский 1-й проезд
Данилівський 2-й проїзд | Даниловский 2-й проезд
Дарвіна вулиця | Дарвина улица
Даргомижського вулиця | Даргомыжского улица
Даргомижського в'їзд | Даргомыжского въезд
Дарницька вулиця | Дарницкая улица
Дар'яльська вулиця | Дарьяльская улица
Дар'яльський провулок | Дарьяльский переулок
Дача № 55 вулиця | Дача № 55 улица
Дачна вулиця | Дачная улица
Дачний провулок | Дачный переулок
Двадцять Другого Січня в'їзд | Двадцать Второго Января въезд
Двадцять Третього Серпня провулок | Двадцать Третьего Августа переулок
Двадцять Третього Серпня вулиця | Двадцать Третьего Августа улица
Дванадцятого Квітня вулиця | Двенадцатого Апреля улица
Двінська вулиця | Двинская улица
Двінський провулок | Двинский переулок
Двінський в'їзд | Двинский въезд
Дворічна вулиця | Двуречная улица
Дебальцівська вулиця | Дебальцевская улица
Дегтярьова провулок | Дегтярева переулок
Декабристів вулиця | Декабристов улица
Делегатська вулиця | Делегатская улица
Делегатський провулок | Делегатский переулок
Дем'яна Бєдного вулиця | Демьяна Бедного улица
Денчика вулиця | Денчика улица
Деповська вулиця | Деповская улица
Деповський 1-й в'їзд | Деповский 1-й въезд
Деповський 1-й провулок | Деповский 1-й переулок
Деповський 2-й в'їзд | Деповский 2-й въезд
Деповський 2-й провулок | Деповский 2-й переулок
Депутатська вулиця | Депутатская улица
Депутатський провулок | Депутатский переулок
Депутатський в'їзд | Депутатский въезд
Дербентська вулиця | Дербентская улица
Дербентський провулок | Дербентский переулок
Дерев'янка вулиця | Деревянко улица
Державінська вулиця | Державинская улица
Деркачівська вулиця | Дергачевская улица
Деснянський провулок | Деснянский переулок
Джанкойська вулиця | Джанкойская улица
Джерело провулок | Джерело переулок
Джерельна вулиця | Родниковая улица
Джерельний провулок | Родниковый переулок
Джутова вулиця | Джутовая улица
Джутовий в'їзд | Джутовый въезд
Джутовий провулок | Джутовый переулок
Дзюби проспект | Дзюбы проспект
Дивногірський провулок | Дивногорский переулок
Дизайнерський провулок | Дизайнерский переулок
Дизельна вулиця | Дизельная улица
Диканівська вулиця | Диканевская улица
Динамівська вулиця | Динамовская улица
Динамівський провулок | Динамовский переулок
Динамічний провулок | Динамический переулок
Диспетчерська вулиця | Диспетчерская улица
Диспетчерський провулок | Диспетчерский переулок
Диспетчерський в'їзд | Диспетчерский въезд
Дитячий провулок | Детский переулок
Дібровна вулиця | Дубровная улица
Дівоча вулиця | Девичья улица
Дігтярний провулок | Дегтярный переулок
Дідро вулиця | Дидро улица
Дмитра Вишневецького провулок | Дмитрия Вишневецкого переулок
Дмитра Вишневецького вулиця | Дмитрия Вишневецкого улица
Дмитра Вишневецького проїзд | Дмитрия Вишневецкого проезд
Дмитра Міллера вулиця | Дмитрия Миллера улица
Дмитрівська вулиця | Дмитриевская улица
Дмітрія Донського вулиця | Дмитрия Донского улица
Дніпровська вулиця | Днепровская улица
Дністровська вулиця | Днестровская улица
Дністровський бульвар | Днестровский бульвар
Дністровський провулок | Днестровский переулок
Дністровський в'їзд | Днестровский въезд
Добродецького провулок | Добродецкого переулок
Добродецького вулиця | Добродецкого улица
Добролюбова вулиця | Добролюбова улица
Доватора провулок | Доватора переулок
Доватора вулиця | Доватора улица
Довгожданий провулок | Долгожданный переулок
Довженка вулиця | Довженко улица
Докучаєва вулиця | Докучаева улица
Докучаєва в'їзд | Докучаева въезд
Докучаєва провулок | Докучаева переулок
Докучаєва 1-й проїзд | Докучаева 1-й проезд
Долинний провулок | Долинный переулок
Долинський провулок | Долинский переулок
Домобудівельна вулиця | Домостроительная улица
Донбасівський проїзд | Донбассовский проезд
Донбасівський провулок | Донбассовский переулок
Донецька вулиця | Донецкая улица
Донецький провулок | Донецкий переулок
Донський провулок | Донской переулок
Донця-Захаржевського вулиця | Донца-Захаржевского улица
Дорожня вулиця | Дорожная улица
Дорохівський провулок | Дороховский переулок
Дорошенківська вулиця | Дорошенковская улица
Дорошенківський 1-й в'їзд | Дорошенковский 1-й въезд
Дорошенківський 1-й провулок | Дорошенковский 1-й переулок
Дорошенківський 2-й в'їзд | Дорошенковский 2-й въезд
Дорошенківський 2-й провулок | Дорошенковский 2-й переулок
Досвідний провулок | Досвидный переулок
Достатку вулиця | Изобилия улица
Достатку провулок | Изобилия переулок
Достоєвського в'їзд | Достоевского въезд
Достоєвського провулок | Достоевского переулок
Достоєвського вулиця | Достоевского улица
Достоєвського проїзд | Достоевского проезд
Достоєвського 1-й в'їзд | Достоевского 1-й въезд
Драгоманова вулиця | Драгоманова улица
Драгомирівська вулиця | Драгомировская улица
Дрінова вулиця | Дринова улица
Дробицька вулиця | Дробицкая улица
Дробицький провулок | Дробицкий переулок
Дрожжинська вулиця | Дрожжинская улица
Дружби вулиця | Дружбы улица
Дружби Народів вулиця | Дружбы Народов улица
Дружби 1-й провулок | Дружбы 1-й переулок
Дружби 2-й провулок | Дружбы 2-й переулок
Дружби 3-й провулок | Дружбы 3-й переулок
Дружна вулиця | Дружная улица
Дружний 1-й провулок | Дружный 1-й переулок
Дружний 2-й провулок | Дружный 2-й переулок
Дубиніна провулок | Дубинина переулок
Дубова вулиця | Дубовая улица
Дубова Алея вулиця | Дубовая Аллея улица
Дубовий 1-й провулок | Дубовый 1-й переулок
Дубовий 2-й провулок | Дубовый 2-й переулок
Дудинської вулиця | Дудинской улица
Дудківська вулиця | Дудковская улица
Дунаєвського проїзд | Дунаевского проезд
Дунаєвського провулок | Дунаевского переулок
Дунаєвського вулиця | Дунаевского улица
Дунайська вулиця | Дунайская улица
Душкіна вулиця | Душкина улица
Евенський 1-й провулок | Эвенский 1-й переулок
Евенський 2-й провулок | Эвенский 2-й переулок
Електрична вулиця | Электрическая улица
Електричний в'їзд | Электрический въезд
Електровозна вулиця | Электровозная улица
Електровозний в'їзд | Электровозный въезд
Електровозний проїзд | Электровозный проезд
Електроінструментальний провулок | Электроинструментальный переулок
Електромеханічний провулок | Электромеханический переулок
Ельбруський провулок | Эльбрусский переулок
Енергетична вулиця | Энергетическая улица
Ерліха вулиця | Эрлиха улица
Естакадна вулиця | Эстакадная улица
Естакадний в'їзд | Эстакадный въезд
Євгена Єгорова провулок | Евгения Егорова переулок
Євгена Єгорова вулиця | Евгения Егорова улица
Євгена Котляра вулиця | Евгения Котляра улица
Євгена Плужника провулок | Евгения Плужника переулок
Євгена Плужника в'їзд | Евгения Плужника въезд
Євгена Плужника вулиця | Евгения Плужника улица
Євгена Решетникова вулиця | Евгения Решетникова улица
Євгенівська вулиця | Евгеньевская улица
Євпаторійський проїзд | Евпаторийский проезд
Євсюківський провулок | Евсюковский переулок
Єйський провулок | Ейский переулок
Єлецький провулок | Елецкий переулок
Єльнінський провулок | Ельненский переулок
Єнакіївська вулиця | Енакиевская улица
Єнакіївський провулок | Енакиевский переулок
Єнісейська вулиця | Енисейская улица
Єрмаківська вулиця | Ермаковская улица
Єрмілова вулиця | Ермилова улица
Єрмолаївський провулок | Ермолаевский переулок
Єсеніна вулиця | Есенина улица
Жасминовий бульвар | Жасминовый бульвар
Желєзноводська вулиця | Железноводская улица
Желябова провулок | Желябова переулок
Женченка вулиця | Женченко улица
Жигаріна вулиця | Жигарина улица
Жигулівський провулок | Жигулевский переулок
Жилинська вулиця | Жилинская улица
Жилинський провулок | Жилинский переулок
Жилинський 1-й проїзд | Жилинский 1-й проезд
Жилинський 2-й проїзд | Жилинский 2-й проезд
Жилинський 3-й проїзд | Жилинский 3-й проезд
Жилинський 4-й проїзд | Жилинский 4-й проезд
Жилинський 5-й проїзд | Жилинский 5-й проезд
Жилинський 6-й проїзд | Жилинский 6-й проезд
Жилинський 7-й проїзд | Жилинский 7-й проезд
Жилівський провулок | Жиловский переулок
Жилярді в'їзд | Жилярди въезд
Жилярді вулиця | Жилярди улица
Жилярді 1-й в'їзд | Жилярди 1-й въезд
Жилярді 2-й в'їзд | Жилярди 2-й въезд
Жилярді 3-й в'їзд | Жилярди 3-й въезд
Житня вулиця | Житная улица
Житомирська вулиця | Житомирская улица
Жихорська вулиця | Жихорская улица
Жихорський проїзд | Жихорский проезд
Жихорський в'їзд | Жихорский въезд
Жмеринська вулиця | Жмеринская улица
Жовтої Троянди вулиця | Желтой Розы улица
Жолудева вулиця | Желудевая улица
Жон Мироносиць вулиця | Жен Мироносиц улица
Жуковського вулиця | Жуковского улица
Жуковського проспект | Жуковского проспект
Журавлівська набережна | Журавлевская набережная
Журавлівський узвіз | Журавлевский спуск
Журавлівський 2-й в'їзд | Журавлевский 2-й въезд
Журавлівський 3-й в'їзд | Журавлевский 3-й въезд
Жутівська вулиця | Жутовская улица
Забайкальська вулиця | Забайкальская улица
Забайкальський провулок | Забайкальский переулок
Заводська вулиця | Заводская улица
Заводський в'їзд | Заводской въезд
Заводський провулок | Заводской переулок
Загородній провулок | Загородний переулок
Загородній проїзд | Загородний проезд
Загородній в'їзд | Загородний въезд
Загородня вулиця | Загородняя улица
Задорна вулиця | Задорная улица
Задорний 1-й провулок | Задорный 1-й переулок
Задорний 2-й провулок | Задорный 2-й переулок
Заїки провулок | Заики переулок
Заїки вулиця | Заики улица
Заїки майдан | Заики площадь
Заїківський провулок | Заиковский переулок
Заливна вулиця | Заливная улица
Залізнична вулиця | Железнодорожная улица
Залізничний провулок | Железнодорожный переулок
Залізничний в'їзд | Железнодорожный въезд
Залізничний проїзд | Железнодорожный проезд
Заліська вулиця | Залесская улица
Залютинська вулиця | Залютинская улица
Залютинський провулок | Залютинский переулок
Залютинський в'їзд | Залютинский въезд
Залютинський 3-й провулок | Залютинский 3-й переулок
Заплавна вулиця | Заплавная улица
Запорізька вулиця | Запорожская улица
Зарічна вулиця | Заречная улица
Затишний в'їзд | Уютный въезд
Затишнянська вулиця | Затишнянская улица
Затишнянський провулок | Затишнянский переулок
Затишнянський проїзд | Затишнянский проезд
Затоківський провулок | Затоковский переулок
Захисників України майдан | Защитников Украины площадь
Західна вулиця | Западная улица
Зачепилівська вулиця | Зачепиловская улица
Звенигородська вулиця | Звенигородская улица
Звенигородський проїзд | Звенигородский проезд
Звенигородський 1-й провулок | Звенигородский 1-й переулок
Звенигородський 1-й проїзд | Звенигородский 1-й проезд
Звенигородський 2-й проїзд | Звенигородский 2-й проезд
Звенигородський 2-й провулок | Звенигородский 2-й переулок
Звільнення провулок | Освобождения переулок
Звільнення вулиця | Освобождения улица
Зв'язку вулиця | Связи улица
Здоров'я провулок | Здоровья переулок
Здоров'я набережна | Здоровья набережная
Зелена вулиця | Зеленая улица
Зелений в'їзд | Зеленый въезд
Зелений провулок | Зеленый переулок
Зелений Гай вулиця | Зеленый Гай улица
Зеленоградська вулиця | Зеленоградская улица
Зеленоградський провулок | Зеленоградский переулок
Зеленоградський в'їзд | Зеленоградский въезд
Зеленодільська вулиця | Зеленодольская улица
Зеленодільський в'їзд | Зеленодольский въезд
Зеленодільський 1-й проїзд | Зеленодольский 1-й проезд
Зеленодільський 2-й проїзд | Зеленодольский 2-й проезд
Зеленодільський 3-й проїзд | Зеленодольский 3-й проезд
Зеленодільський 5-й проїзд | Зеленодольский 5-й проезд
Зеленодільський 6-й проїзд | Зеленодольский 6-й проезд
Землемірний провулок | Землемерный переулок
Земовська вулиця | Земовская улица
Земовський провулок | Земовский переулок
Зернова вулиця | Зерновая улица
Зерновий провулок | Зерновой переулок
Зерновий 1-й проїзд | Зерновой 1-й проезд
Зерновий 2-й проїзд | Зерновой 2-й проезд
Зерновий 3-й проїзд | Зерновой 3-й проезд
Зерновий 4-й проїзд | Зерновой 4-й проезд
З'єднана вулиця | Соединенная улица
Змагання вулиця | Соревнования улица
Зміївська вулиця | Змиевская улица
Зміївський 3-й в'їзд | Змиевский 3-й въезд
Знам'янська вулиця | Знаменская улица
Золотарівський провулок | Золотаревский переулок
Золотарівський проїзд | Золотаревский проезд
Золотий провулок | Золотой переулок
Золотий 1-й в'їзд | Золотой 1-й въезд
Золотий 2-й в'їзд | Золотой 2-й въезд
Золочівська вулиця | Золочевская улица
Золочівський 1-й провулок | Золочевский 1-й переулок
Золочівський 2-й провулок | Золочевский 2-й переулок
Зоряна вулиця | Звездная улица
Зоряний провулок | Зоряный переулок
Зоряний в'їзд | Зоряный въезд
Зорянська вулиця | Зорянская улица
Зубарєва вулиця | Зубарева улица
Івана Багмута вулиця | Ивана Багмута улица
Івана Багряного вулиця | Ивана Багряного улица
Івана Зарудного вулиця | Ивана Зарудного улица
Івана Зарудного в'їзд | Ивана Зарудного въезд
Івана Зарудного провулок | Ивана Зарудного переулок
Івана Каркача в'їзд | Ивана Каркача въезд
Івана Каркача проїзд | Ивана Каркача проезд
Івана Каркача бульвар | Ивана Каркача бульвар
Івана Каркача провулок | Ивана Каркача переулок
Івана Кобзи вулиця | Ивана Кобзы улица
Івана Піддубного вулиця | Ивана Поддубного улица
Івана Сірка провулок | Ивана Сирко переулок
Івана Сірка вулиця | Ивана Сирко улица
Іванівська набережна | Ивановская набережная
Іванівська вулиця | Ивановская улица
Іванівський провулок | Ивановский переулок
Івченка провулок | Ивченко переулок
Ігоря Муратова вулиця | Игоря Муратова улица
Ігоря Муратова 1-й провулок | Игоря Муратова 1-й переулок
Ігоря Муратова 2-й провулок | Игоря Муратова 2-й переулок
Іжевська вулиця | Ижевская улица
Іжевський провулок | Ижевский переулок
Ізмайлівська вулиця | Измайловская улица
Ізюмська вулиця | Изюмская улица
Іллі Ліфшиця вулиця | Ильи Лифшица улица
Іллінська вулиця | Ильинская улица
Ільменська вулиця | Ильменская улица
Індустріальна вулиця | Индустриальная улица
Індустріальний в'їзд | Индустриальный въезд
Інженерний провулок | Инженерный переулок
Ініціативна вулиця | Инициативная улица
Інтернатська вулиця | Интернатская улица
Інтернаціональна вулиця | Интернациональная улица
Інтернаціональний провулок | Интернациональный переулок
Інтернаціональний в'їзд | Интернациональный въезд
Ірисовий в'їзд | Ирисовый въезд
Іртиська вулиця | Иртышская улица
Іртиський провулок | Иртышский переулок
Ісаївська вулиця | Исаевская улица
Ісаївський провулок | Исаевский переулок
Ісаївський 1-й в'їзд | Исаевский 1-й въезд
Ісаївський 2-й в'їзд | Исаевский 2-й въезд
Ісаївський 3-й в'їзд | Исаевский 3-й въезд
Ісаївський 4-й в'їзд | Исаевский 4-й въезд
Ісаївський 5-й в'їзд | Исаевский 5-й въезд
Ісаївський 6-й в'їзд | Исаевский 6-й въезд
Іскринська вулиця | Искринская улица
Іскринський провулок | Искринский переулок
Істомінська вулиця | Истоминская улица
Істомінський провулок | Истоминский переулок
Істомінський 1-й провулок | Истоминский 1-й переулок
Істомінський 2-й провулок | Истоминский 2-й переулок
Кабанова Дача вулиця | Кабанова Дача улица
Кабардинська вулиця | Кабардинская улица
Кавалерідзе вулиця | Кавалеридзе улица
Кавалерійська вулиця | Кавалерийская улица
Казахстанська вулиця | Казахстанская улица
Калинова вулиця | Калиновая улица
Калиновий провулок | Калиновый переулок
Калузька вулиця | Калужская улица
Калузький провулок | Калужский переулок
Каляєва провулок | Каляева переулок
Каменський провулок | Каменский переулок
Каменський в'їзд | Каменский въезд
Камишева Івана вулиця | Камышева Ивана улица
Камишова вулиця | Камишовая улица
Камська вулиця | Камская улица
Кам'янець-Подільська вулиця | Каменец-Подольская улица
Кам'янець-Подільський провулок | Каменец-Подольский переулок
Канатний провулок | Канатный переулок
Кандаурова вулиця | Кандаурова улица
Кантемира провулок | Кантемира переулок
Каплунівський провулок | Каплуновский переулок
Капніста провулок | Капниста переулок
Капустянська вулиця | Капустянская улица
Капустянський провулок | Капустянский переулок
Карагандинська вулиця | Карагандинская улица
Каразіна вулиця | Каразина улица
Каракозова провулок | Каракозова переулок
Карамзіна в'їзд | Карамзина въезд
Карамзіна вулиця | Карамзина улица
Карачівське шосе | Карачевское шоссе
Карачівський в'їзд | Карачевский въезд
Карбишева провулок | Карбышева переулок
Кар'єрна вулиця | Карьерная улица
Кар'єрний провулок | Карьерный переулок
Каринської вулиця | Каринской улица
Кармелюка вулиця | Кармелюка улица
Карнакова провулок | Карнакова переулок
Карпатська вулиця | Карпатская улица
Карпатський провулок | Карпатский переулок
Карпатський проїзд | Карпатский проезд
Карпатський 1-й проїзд | Карпатский 1-й проезд
Карпатський 2-й проїзд | Карпатский 2-й проезд
Карпинського вулиця | Карпинского улица
Карпівська вулиця | Карповская улица
Карпівський провулок | Карповский переулок
Карпівський узвіз | Карповский спуск
Карташівська вулиця | Карташевская улица
Карташівський провулок | Карташевский переулок
Карякінська вулиця | Карякинская улица
Касимівський в'їзд | Касимовский въезд
Катаєва в'їзд | Катаева въезд
Катаєва вулиця | Катаева улица
Катерининська вулиця | Катерининская улица
Каунаська вулиця | Каунасская улица
Каунаський провулок | Каунасский переулок
Каховська вулиця | Каховская улица
Каховський 1-й провулок | Каховский 1-й переулок
Каховський 2-й провулок | Каховский 2-й переулок
Качанівська вулиця | Качановская улица
Каширська вулиця | Каширская улица
Каштанова вулиця | Каштановая улица
Кашуби вулиця | Кашубы улица
Квіткинська вулиця | Квиткинская улица
Квітки-Основ'яненка вулиця | Квитки-Основьяненко улица
Квіткова вулиця | Цветочная улица
Квітковий в'їзд | Цветочный въезд
Квітуча вулиця | Квитучая улица
Квітучий провулок | Квитучий переулок
Кегичівська вулиця | Кегичевская улица
Кедровий провулок | Кедровый переулок
Кедровий проїзд | Кедровый проезд
Кемеровська вулиця | Кемеровская улица
Керамічна вулиця | Керамическая улица
Керамічний проїзд | Керамический проезд
Керамічний 1-й провулок | Керамический 1-й переулок
Керамічний 2-й провулок | Керамический 2-й переулок
Керамічний 3-й в'їзд | Керамический 3-й въезд
Керамічний 4-й в'їзд | Керамический 4-й въезд
Керамічний 5-й в'їзд | Керамический 5-й въезд
Керченська вулиця | Керченская улица
Керченський провулок | Керченский переулок
Кибальчича вулиця | Кибальчича улица
Київська вулиця | Киевская улица
Кипарисова вулиця | Кипарисовая улица
Киргизька вулиця | Киргизская улица
Киргизький проїзд | Киргизский проезд
Кирилівська вулиця | Кирилловская улица
Кирилівський провулок | Кирилловский переулок
Кирпичова вулиця | Кирпичева улица
Кисловодська вулиця | Кисловодская улица
Кисловодський провулок | Кисловодский переулок
Кисляк вулиця | Кисляк улица
Китаєнка вулиця | Китаенко улица
Кільцева вулиця | Кольцевая улица
Кільцевий проїзд | Кольцевой проезд
Кільцевий 1-й провулок | Кольцевой 1-й переулок
Кільцевий 2-й провулок | Кольцевой 2-й переулок
Кінний провулок | Конный переулок
Кіпренський провулок | Кипренский переулок
Кітляров в'їзд | Китляров въезд
Кітляров провулок | Китляров переулок
Кітляров Ручай вулиця | Китляров Ручей улица
Кішинська вулиця | Кишинская улица
Кішинський провулок | Кишинский переулок
Кішинський проїзд | Кишинский проезд
Класичний провулок | Классический переулок
Клеверний провулок | Клеверный переулок
Клеменівська вулиця | Клеменовская улица
Клеменова Дача проїзд | Клеменова Дача проезд
Клеменова Дача в'їзд | Клеменова Дача въезд
Клеменова Дача вулиця | Клеменова Дача улица
Клеменова Дача провулок | Клеменова Дача переулок
Кленова вулиця | Кленовая улица
Клещівський провулок | Клещевский переулок
Климовського проїзд | Климовского проезд
Климовського провулок | Климовского переулок
Климовського 1-й в'їзд | Климовского 1-й въезд
Климовського 2-й в'їзд | Климовского 2-й въезд
Клинська вулиця | Клинская улица
Клочківська вулиця | Клочковская улица
Клочківський провулок | Клочковский переулок
Клочківський узвіз | Клочковский спуск
Клочкова вулиця | Клочкова улица
Клочкова провулок | Клочкова переулок
Клубна вулиця | Клубная улица
Клубний провулок | Клубный переулок
Ключова вулиця | Ключевая улица
Книшівський провулок | Кнышевский переулок
Кобзарський провулок | Кобзарский переулок
Ковача провулок | Ковача переулок
Ковильний провулок | Ковыльный переулок
Ковтуна вулиця | Ковтуна улица
Ков'язький провулок | Ковяжский переулок
Кожедуба вулиця | Кожедуба улица
Козакевича вулиця | Козакевича улица
Козацька вулиця | Казацкая улица
Козюлінська вулиця | Козюлинская улица
Коксова вулиця | Коксовая улица
Коксовий провулок | Коксовый переулок
Кокчетавська вулиця | Кокчетавская улица
Колективна вулиця | Коллективная улица
Колекторна вулиця | Коллекторная улица
Колійний провулок | Колейный переулок
Колісниченківська вулиця | Колесниченковская улица
Колісниченківський 1-й провулок | Колесниченковский 1-й переулок
Колісниченківський 2-й провулок | Колесниченковский 2-й переулок
Колісниченківський 3-й провулок | Колесниченковский 3-й переулок
Колодязна вулиця | Колодезная улица
Колодязний провулок | Колодезный переулок
Коломацький провулок | Коломацкий переулок
Коломенська вулиця | Коломенская улица
Колонна вулиця | Колонная улица
Колонний 1-й провулок | Колонный 1-й переулок
Колонний 2-й провулок | Колонный 2-й переулок
Колонний 3-й провулок | Колонный 3-й переулок
Колонний 4-й провулок | Колонный 4-й переулок
Колосиста вулиця | Колосистая улица
Колосистий провулок | Колосистый переулок
Колосистий в'їзд | Колосистый въезд
Кольський провулок | Кольский переулок
Кольцова в'їзд | Кольцова въезд
Кольцовська вулиця | Кольцовская улица
Комбайнівська вулиця | Комбайновская улица
Комишанська вулиця | Камышанская улица
Комітетська вулиця | Комитетская улица
Комунальна вулиця | Коммунальная улица
Комунальний в'їзд | Коммунальный въезд
Комунальний проїзд | Коммунальный проезд
Кондукторська вулиця | Кондукторская улица
Кондукторський провулок | Кондукторский переулок
Конєва вулиця | Конева улица
Коновалова вулиця | Коновалова улица
Коновченка в'їзд | Коновченко въезд
Коновченка вулиця | Коновченко улица
Коновченка провулок | Коновченко переулок
Конопльова вулиця | Коноплева улица
Конопляна вулиця | Конопляная улица
Конопляний провулок | Конопляный переулок
Конопляний проїзд | Конопляный проезд
Конотопська вулиця | Конотопская улица
Конотопський провулок | Конотопский переулок
Конституції майдан | Конституции площадь
Конструкторська вулиця | Конструкторская улица
Конструкторський проїзд | Конструкторский проезд
Конструкторський провулок | Конструкторский переулок
Конторська вулиця | Конторская улица
Конторський провулок | Конторский переулок
Конюшенний провулок | Конюшенный переулок
Кооперативна вулиця | Кооперативная улица
Коперніка вулиця | Коперника улица
Копиленка вулиця | Копыленко улица
Копиловська вулиця | Копыловская улица
Копиловський провулок | Копыловский переулок
Корабельна вулиця | Корабельная улица
Корейський провулок | Корейский переулок
Коробейницький провулок | Коробейницкий переулок
Коровченківський провулок | Коровченковский переулок
Короленка вулиця | Короленко улица
Короленка провулок | Короленко переулок
Коростельська вулиця | Коростельская улица
Коростельський провулок | Коростельский переулок
Коростенський проїзд | Коростенский проезд
Коростенський в'їзд | Коростенский въезд
Короткий провулок | Короткий переулок
Коротченківська вулиця | Коротченковская улица
Корсиківський провулок | Корсиковский переулок
Корсиківський проїзд | Корсиковский проезд
Корсунська вулиця | Корсунская улица
Коршунова вулиця | Коршунова улица
Косарєва вулиця | Косарева улица
Космічна вулиця | Космическая улица
Космонавтів вулиця | Космонавтов улица
Костичева вулиця | Костычева улица
Костомарівська вулиця | Костомаровская улица
Костромська вулиця | Костромская улица
Костромський провулок | Костромской переулок
Костьольна вулиця | Костельная улица
Костюринський провулок | Костюринский переулок
Костянтина Калініна вулиця | Константина Калинина улица
Костянтина Калініна в'їзд | Константина Калинина въезд
Костянтина Калініна провулок | Константина Калинина переулок
Костянтина Челпана провулок | Константина Челпана переулок
Костянтинівська вулиця | Константиновская улица
Котельна вулиця | Котельная улица
Котельний провулок | Котельный переулок
Котельниківська вулиця | Котельниковская улица
Котласька вулиця | Котласская улица
Котласький 1-й проїзд | Котласский 1-й проезд
Котласький 2-й проїзд | Котласский 2-й проезд
Котляревського вулиця | Котляревского улица
Котляри провулок | Котляры переулок
Кохання вулиця | Кохання улица
Кохання провулок | Кохання переулок
Коцарська вулиця | Коцарская улица
Коцюбинського вулиця | Коцюбинского улица
Кочетоцька вулиця | Кочетокская улица
Кочубеївська вулиця | Кочубеевская улица
Кошевого провулок | Кошевого переулок
Кошевого вулиця | Кошевого улица
Кошкіна вулиця | Кошкина улица
Кравцова провулок | Кравцова переулок
Крамаренківська вулиця | Крамаренковская улица
Краматорська вулиця | Краматорская улица
Краматорський провулок | Краматорский переулок
Крамова вулиця | Крамова улица
Крамчанинівська вулиця | Крамчаниновская улица
Красна Поляна вулиця | Красная Поляна улица
Красноводський провулок | Красноводский переулок
Красноградська вулиця | Красноградская улица
Краснодарська вулиця | Краснодарская улица
Краснодарський провулок | Краснодарский переулок
Краснодарський проїзд | Краснодарский проезд
Краснодарський 2-й провулок | Краснодарский 2-й переулок
Краснокутська вулиця | Краснокутская улица
Краснокутський провулок | Краснокутский переулок
Красноморський провулок | Красноморский переулок
Краснопільська вулиця | Краснопольская улица
Красноуральська вулиця | Красноуральская улица
Красноярська вулиця | Красноярская улица
Красноярський провулок | Красноярский переулок
Кременчуцька вулиця | Кременчугская улица
Кремлівська вулиця | Кремлевская улица
Кречетівський провулок | Кречетовский переулок
Кривоконівська вулиця | Кривоконевская улица
Кривоконівський провулок | Кривоконевский переулок
Криворізька вулиця | Криворожская улица
Криворізький провулок | Криворожский переулок
Крилова в'їзд | Крылова въезд
Крилова провулок | Крылова переулок
Крилова вулиця | Крылова улица
Крилова 1-й в'їзд | Крылова 1-й въезд
Крилова 2-й в'їзд | Крылова 2-й въезд
Кримська вулиця | Крымская улица
Криничний провулок | Криничный переулок
Кричевського провулок | Кричевского переулок
Кричевського вулиця | Кричевского улица
Кришталевий провулок | Хрустальный переулок
Кромська вулиця | Кромская улица
Кронштадтська вулиця | Кронштадтская улица
Кронштадтський провулок | Кронштадтский переулок
Кропивний провулок | Крапивный переулок
Кропивницького провулок | Кропивницкого переулок
Кропивницького вулиця | Кропивницкого улица
Крохмалівський провулок | Крохмалевский переулок
Кругова вулиця | Круговая улица
Крутий провулок | Крутой переулок
Крутогірський провулок | Крутогорский переулок
Крушельницького проїзд | Крушельницкого проезд
Крушельницького вулиця | Крушельницкого улица
Крушельницького провулок | Крушельницкого переулок
Крюківська вулиця | Крюковская улица
Крючонкіна вулиця | Крюченкина улица
Крючонкіна проїзд | Крюченкина проезд
Крючонкіна провулок | Крюченкина переулок
Кубанська вулиця | Кубанская улица
Кубанський провулок | Кубанский переулок
Кубраківський провулок | Кубраковский переулок
Кузинський Двір в'їзд | Кузинский Двор въезд
Кузнецька вулиця | Кузнецкая улица
Кузнецький провулок | Кузнецкий переулок
Кузнецький в'їзд | Кузнецкий въезд
Кузнечна вулиця | Кузнечная улица
Кузнечний провулок | Кузнечный переулок
Кузнечний в'їзд | Кузнечный въезд
Кулєшова вулиця | Кулешова улица
Кулєшова провулок | Кулешова переулок
Куликівська вулиця | Куликовская улица
Куликівський узвіз | Куликовский спуск
Кулиничівська вулиця | Кулиничевская улица
Кулиничівський в'їзд | Кулиничевский въезд
Кулиничівський провулок | Кулиничевский переулок
Кулібіна провулок | Кулибина переулок
Куліша вулиця | Кулиша улица
Кульбицький провулок | Кульбицкий переулок
Культури вулиця | Культуры улица
Кульчицького вулиця | Кульчицкого улица
Купинова вулиця | Купиновая улица
Купиновий в'їзд | Купиновый въезд
Купиновий 1-й провулок | Купиновый 1-й переулок
Купиновий 2-й провулок | Купиновый 2-й переулок
Купиновий 3-й провулок | Купиновый 3-й переулок
Куп'янська вулиця | Купянская улица
Курахівська вулиця | Кураховская улица
Курбаса вулиця | Курбаса улица
Курганський провулок | Курганский переулок
Курилівська вулиця | Куриловская улица
Курилівський в'їзд | Куриловский въезд
Курська вулиця | Курская улица
Курський провулок | Курский переулок
Куряжанська вулиця | Куряжанская улица
Куряжанський провулок | Куряжанский переулок
Куряжанський в'їзд | Куряжанский въезд
Кустанайська вулиця | Кустанайская улица
Кустанайський проїзд | Кустанайский проезд
Кустанайський провулок | Кустанайский переулок
Кутаїська вулиця | Кутаисская улица
Кутаїський 1-й в'їзд | Кутаисский 1-й въезд
Кутаїський 2-й в'їзд | Кутаисский 2-й въезд
Кутєпова вулиця | Кутепова улица
Кутова вулиця | Кутова улица
Кутузівська вулиця | Кутузовская улица
Кучеренка провулок | Кучеренко переулок
Кюї Цезаря вулиця | Кюи Цезаря улица
Лаврентіївський провулок | Лаврентьевский переулок
Лаврентьєва провулок | Лаврентьева переулок
Лаврика вулиця | Лаврика улица
Ладигіна в'їзд | Ладыгина въезд
Ладигіна провулок | Ладыгина переулок
Ладозький провулок | Ладожский переулок
Лазаревича вулиця | Лазаревича улица
Лазарівський провулок | Лазаревский переулок
Лазьківка-Лужок вулиця | Лазьковка-Лужок улица
Лазьківський провулок | Лазьковский переулок
Лазьківський проїзд | Лазьковский проезд
Лазьківський 1-й в'їзд | Лазьковский 1-й въезд
Лазьківський 2-й в'їзд | Лазьковский 2-й въезд
Лазьківський 3-й в'їзд | Лазьковский 3-й въезд
Ландау вулиця | Ландау улица
Ландау провулок | Ландау переулок
Лаптенківська вулиця | Лаптенковская улица
Латвійська вулиця | Латвийская улица
Латвійський провулок | Латвийский переулок
Латишева вулиця | Латышева улица
Лебедєва-Кумача вулиця | Лебедева-Кумача улица
Лебединська вулиця | Лебединская улица
Лебединця вулиця | Лебединца улица
Леб'яжий в'їзд | Лебяжий въезд
Левченка вулиця | Левченко улица
Лейпунського провулок | Лейпунского переулок
Лейпунського вулиця | Лейпунского улица
Лелюківська вулиця | Лелюковская улица
Лелюківський провулок | Лелюковский переулок
Лелюківський провулок | Лелюковский переулок
Ленкоранська вулиця | Ленкоранская улица
Леоніда Бикова вулиця | Леонида Быкова улица
Леоніда Бикова провулок | Леонида Быкова переулок
Леоніда Тарабарінова вулиця | Леонида Тарабаринова улица
Лермонтовська вулиця | Лермонтовская улица
Лесі Українки вулиця | Леси Украинки улица
Леся Дубовика вулиця | Леся Дубовика улица
Леся Сердюка вулиця | Леся Сердюка улица
Ливарний провулок | Литейный переулок
Лиманська вулиця | Лиманская улица
Лиманський провулок | Лиманский переулок
Лимаря вулиця | Лымаря улица
Линецького вулиця | Линецкого улица
Липецька вулиця | Липецкая улица
Липова вулиця | Липовая улица
Липцівська вулиця | Липцевская улица
Лиса вулиця | Лысая улица
Лисаветинська вулиця | Елизаветинская улица
Лисенка вулиця | Лысенко улица
Лисичанська вулиця | Лисичанская улица
Лисогірський провулок | Лысогорский переулок
Лисогірський 1-й в'їзд | Лысогорский 1-й въезд
Лисогірський 2-й в'їзд | Лысогорский 2-й въезд
Лисогірський 3-й в'їзд | Лысогорский 3-й въезд
Лисогірський 4-й в'їзд | Лысогорский 4-й въезд
Листяний провулок | Лиственный переулок
Литвинівська вулиця | Литвиновская улица
Лівобережна вулиця | Левобережная улица
Лідії Криницької провулок | Лидии Криницкой переулок
Ліднянський в'їзд | Леднянский въезд
Ліднянський провулок | Леднянский переулок
Лінійна вулиця | Линейная улица
Лінійний провулок | Линейный переулок
Лісова вулиця | Лесная улица
Лісозахисна вулиця | Лесозащитная улица
Лісозахисний провулок | Лесозащитный переулок
Лісопарківська вулиця | Лесопарковская улица
Лісопарківський 1-й провулок | Лесопарковский 1-й переулок
Лісопарківський 2-й провулок | Лесопарковский 2-й переулок
Літакова вулиця | Самолетная улица
Літературна вулиця | Литературная улица
Ліщинова вулиця | Лещиновая улица
Ліщиновий проїзд | Лещиновый проезд
Ліщиновий провулок | Лещиновый переулок
Лобачевського вулиця | Лобачевского улица
Ловцова вулиця | Ловцова улица
Лодзька вулиця | Лодзинская улица
Лозівська вулиця | Лозовская улица
Лозовеньківський проспект | Лозовеньковский проспект
Локомотивна вулиця | Локомотивная улица
Ломоносова в'їзд | Ломоносова въезд
Ломоносова провулок | Ломоносова переулок
Ломоносова вулиця | Ломоносова улица
Лопанська вулиця | Лопанская улица
Лопанська набережна | Лопанская набережная
Лопанський провулок | Лопанский переулок
Лопатинська набережна | Лопатинская набережная
Лопатинський провулок | Лопатинский переулок
Лосівська вулиця | Лосевская улица
Лосівський в'їзд | Лосевский въезд
Лосівський провулок | Лосевский переулок
Луб'янська вулиця | Лубянская улица
Луганська вулиця | Луганская улица
Лугівська вулиця | Луговская улица
Лугівський провулок | Луговской переулок
Лугова вулиця | Луговая улица
Луговий провулок | Луговой переулок
Луговий 1-й проїзд | Луговой 1-й проезд
Луговий 2-й проїзд | Луговой 2-й проезд
Луговий 3-й проїзд | Луговой 3-й проезд
Лугопаркова вулиця | Лугопарковая улица
Луї Пастера проїзд | Луи Пастера проезд
Луї Пастера провулок | Луи Пастера переулок
Луї Пастера вулиця | Луи Пастера улица
Луї Пастера 1-й в'їзд | Луи Пастера 1-й въезд
Луї Пастера 2-й в'їзд | Луи Пастера 2-й въезд
Луї Пастера 3-й в'їзд | Луи Пастера 3-й въезд
Луї Пастера 4-й в'їзд | Луи Пастера 4-й въезд
Лук'янівська вулиця | Лукьяновская улица
Лучківська вулиця | Лучковская улица
Лучківський в'їзд | Лучковский въезд
Лучківський провулок | Лучковский переулок
Льва Ландау проспект | Льва Ландау проспект
Льговська вулиця | Льговская улица
Любові Малої проспект | Любови Малой проспект
Люботинський провулок | Люботинский переулок
Людвіга Свободи проспект | Людвига Свободы проспект
Людмили Гурченко провулок | Людмилы Гурченко переулок
Люсинська вулиця | Люсинская улица
Лютівська вулиця | Лютовская улица
Лялі Убийвовк вулиця | Ляли Убийвовк улица
Ляпунова вулиця | Ляпунова улица
Магаданська вулиця | Магаданская улица
Магістральна вулиця | Магистральная улица
Магістральний в'їзд | Магистральный въезд
Магістральний проїзд | Магистральный проезд
Магнітогорська вулиця | Магнитогорская улица
Майкова в'їзд | Майкова въезд
Майкопська вулиця | Майкопская улица
Майкопський провулок | Майкопский переулок
Макаренка вулиця | Макаренко улица
Макарівська вулиця | Макаровская улица
Макіївська вулиця | Макеевская улица
Макіївський провулок | Макеевский переулок
Макіївський 2-й в'їзд | Макеевский 2-й въезд
Макіївський 3-й в'їзд | Макеевский 3-й въезд
Маковий провулок | Маковый переулок
Маковського провулок | Маковского переулок
Маковського вулиця | Маковского улица
Максиміліанівська вулиця | Максимилиановская улица
Мала Гончарівська вулиця | Мало-Гончаровская улица
Мала Кільцева вулиця | Малая Кольцевая улица
Мала Панасівська вулиця | Мало-Панасовская улица
Малинівська вулиця | Малиновская улица
Малишева провулок | Малышева переулок
Малишева вулиця | Малышева улица
Маліновського вулиця | Малиновского улица
Малоджанкойська вулиця | Малоджанкойская улица
Маломосковська вулиця | Маломосковская улица
Малом'ясницька вулиця | Маломясницкая улица
Мало-Панасівський провулок | Мало-Панасовский переулок
Мало-Черновський провулок | Мало-Черновский переулок
Манагарова вулиця | Манагарова улица
Маневровий провулок | Маневровый переулок
Манізера вулиця | Манизера улица
Манченківська вулиця | Манченковская улица
Марата в'їзд | Марата въезд
Маргариновий провулок | Маргариновый переулок
Маримонтська вулиця | Маримонтская улица
Марії Пилинської вулиця | Марии Пилинской улица
Маріупольський провулок | Мариупольский переулок
Мар'ївська вулиця | Марьевская улица
Мар'ївський в'їзд | Марьевский въезд
Мар'їнська вулиця | Марьинская улица
Марка Бернеса вулиця | Марка Бернеса улица
Марка Вовчка вулиця | Марко Вовчок улица
Марка Вовчка в'їзд | Марко Вовчок въезд
Марфінська вулиця | Марфинская улица
Маршака провулок | Маршака переулок
Маршака вулиця | Маршака улица
Маршака 1-й в'їзд | Маршака 1-й въезд
Маршака 2-й в'їзд | Маршака 2-й въезд
Маршала Бажанова вулиця | Маршала Бажанова улица
Маршала Батицького вулиця | Маршала Батицкого улица
Мар'яненка провулок | Марьяненко переулок
Масивна вулиця | Массивная улица
Матеріалістичний провулок | Материалистический переулок
Матросова вулиця | Матросова улица
Матюшенка вулиця | Матюшенко улица
Мацієвича вулиця | Мациевича улица
Машиністів провулок | Машинистов переулок
Машиністів вулиця | Машинистов улица
Машиністів в'їзд | Машинистов въезд
Машинобудівна вулиця | Машиностроительная улица
Машинобудівний в'їзд | Машиностроительный въезд
Машинобудівний провулок | Машиностроительный переулок
Маяковського вулиця | Маяковского улица
Медична вулиця | Медицинская улица
Медичний провулок | Медицинский переулок
Межовий провулок | Межевой переулок
Менделєєва вулиця | Менделеева улица
Мереф'янське шосе | Мерефянское шоссе
Металіста провулок | Металлиста переулок
Металіста вулиця | Металлиста улица
Металургічна вулиця | Металлургическая улица
Метизний провулок | Метизный переулок
Метробудівників вулиця | Метростроителей улица
Метробудівський провулок | Метростроевский переулок
Мефодіївська вулиця | Мефодиевская улица
Механізаторів вулиця | Механизаторов улица
Механізаторський 1-й провулок | Механизаторский 1-й переулок
Механічний провулок | Механический переулок
Мечнікова провулок | Мечникова переулок
Мещанінова вулиця | Мещанинова улица
Мжівський провулок | Мжовский переулок
Микитенка вулиця | Микитенко улица
Микитенка провулок | Микитенко переулок
Микитинський провулок | Никитинский переулок
Миколи Алексіна провулок | Николая Алексина переулок
Миколи Бажана вулиця | Николая Бажана улица
Миколи Манойла вулиця | Николая Манойло улица
Миколи Міхновського вулиця | Николая Михновского улица
Миколи Топчія в'їзд | Николая Топчия въезд
Миргородська вулиця | Миргородская улица
Мирна вулиця | Мирная улица
Миролюбна вулиця | Миролюбивая улица
Миронівська вулиця | Мироновская улица
Мироносицька вулиця | Мироносицкая улица
Миру провулок | Мира переулок
Миру вулиця | Мира улица
Миру бульвар | Мира бульвар
Мистецтв вулиця | Искусств улица
Митрофанівська вулиця | Митрофановская улица
Митрофанівський провулок | Митрофановский переулок
Михайла Водяного вулиця | Михаила Водяного улица
Михайла Гуревича вулиця | Михаила Гуревича улица
Михайла Зеленіна в'їзд | Михаила Зеленина въезд
Михайла Зеленіна вулиця | Михаила Зеленина улица
Михайла Петренка вулиця | Михаила Петренко улица
Михайлика вулиця | Михайлика улица
Михайлівська вулиця | Михайловская улица
Михайлівський в'їзд | Михайловский въезд
Мищенківська вулиця | Мищенковская улица
Міжнародна вулиця | Международная улица
Мінераловодська вулиця | Минераловодская улица
Мінеральна вулиця | Минеральная улица
Мінеральний 1-й провулок | Минеральный 1-й переулок
Мінеральний 2-й провулок | Минеральный 2-й переулок
Мініна вулиця | Минина улица
Мінська вулиця | Минская улица
Мінський провулок | Минский переулок
Місцева вулиця | Местная улица
Міськрадівська вулиця | Горсоветовская улица
Мітингова вулиця | Митинговая улица
Мітинговий провулок | Митинговый переулок
Міхаловського вулиця | Михаловского улица
Мічуріна провулок | Мичурина переулок
Мічуріна набережна | Мичурина набережная
Мічуріна вулиця | Мичурина улица
Мічуріна в'їзд | Мичурина въезд
Млотковського вулиця | Млотковского улица
Мовчанівський в'їзд | Молчановский въезд
Мовчанівський провулок | Молчановский переулок
Могилівська вулиця | Могилевская улица
Могилівський провулок | Могилевский переулок
Моєчна вулиця | Моечная улица
Можайська вулиця | Можайская улица
Мозирський провулок | Мозырський переулок
Мойсеївська вулиця | Моисеевская улица
Молодіжна вулиця | Молодежная улица
Молодогвардійська вулиця | Молодогвардейская улица
Молодої Гвардії вулиця | Молодой Гвардии улица
Молодості вулиця | Молодости улица
Молокіна вулиця | Молокина улица
Молочна вулиця | Молочная улица
Монгольський провулок | Монгольский переулок
Монтажна вулиця | Монтажная улица
Монюшка вулиця | Монюшко улица
Морозова вулиця | Морозова улица
Мороховецька набережна | Мороховецкая набережная
Мороховецький провулок | Мороховецкий переулок
Моршанська вулиця | Моршанская улица
Моршанський провулок | Моршанский переулок
Москаленка вулиця | Москаленко улица
Москаленка провулок | Москаленко переулок
Москалівська вулиця | Москалевская улица
Москалівський в'їзд | Москалевский въезд
Москвіна провулок | Москвина переулок
Московська вулиця | Московская улица
Московський в'їзд | Московский въезд
Московський проспект | Московский проспект
Моторна вулиця | Моторная улица
Мотронінська вулиця | Мотронинская улица
Мотронінський провулок | Мотронинский переулок
Мохнацька вулиця | Мохначанская улица
Мохнацький в'їзд | Мохначанский въезд
Мохова вулиця | Моховая улица
Моцарта вулиця | Моцарта улица
Музична вулиця | Музыкальная улица
Музичний в'їзд | Музыкальный въезд
Муравйова вулиця | Муравьева улица
Мурманська вулиця | Мурманская улица
Мурмилівський провулок | Мурмыловский переулок
Муромська вулиця | Муромская улица
Муромський проїзд | Муромский проезд
Муромський провулок | Муромский переулок
Мусоргського провулок | Мусоргского переулок
Мухачова вулиця | Мухачева улица
М'ясний провулок | Мясной переулок
Набережна вулиця | Набережная улица
Набережний проїзд | Набережный проезд
Набережний в'їзд | Набережный въезд
Набережний провулок | Набережный переулок
Набойченка Петра вулиця | Набойченко Петра улица
Набоківський в'їзд | Набоковский въезд
Нагірна вулиця | Нагорная улица
Надбірна вулиця | Надборная улица
Надбірний провулок | Надборный переулок
Надбірний в'їзд | Надборный въезд
Надіївська вулиця | Надеждинская улица
Надточіївська вулиця | Надточиевская улица
Надточіївський провулок | Надточиевский переулок
Нанайський провулок | Нанайский переулок
Нансена вулиця | Нансена улица
Нарвська вулиця | Нарвская улица
Наринська вулиця | Нарынская улица
Народна вулиця | Народная улица
Народовладдя вулиця | Народовластия улица
Нарофомінська вулиця | Нарофоминская улица
Науки проспект | Науки проспект
Наукова вулиця | Научная улица
Наумівська вулиця | Наумовская улица
Наумівський провулок | Наумовский переулок
Нахімова вулиця | Нахимова улица
Нахімова провулок | Нахимова переулок
Нахічеванський провулок | Нахичеванский переулок
Національної Гвардії майдан | Национальной Гвардии площадь
Небоженківська вулиця | Небоженковская улица
Небоженківський провулок | Небоженковский переулок
Невельська вулиця | Невельская улица
Невельський провулок | Невельский переулок
Невельський проїзд | Невельский проезд
Незалежності проспект | Независимости проспект
Некрасова провулок | Некрасова переулок
Некрасова вулиця | Некрасова улица
Неманська вулиця | Неманская улица
Неманський провулок | Неманский переулок
Неманський 1-й проїзд | Неманский 1-й проезд
Неманський 2-й проїзд | Неманский 2-й проезд
Неманський 3-й проїзд | Неманский 3-й проезд
Неманський 4-й проїзд | Неманский 4-й проезд
Немишлянська набережна | Немышлянская набережная
Немишлянська вулиця | Немышлянская улица
Немишлянський 1-й в'їзд | Немышлянский 1-й въезд
Немишлянський 2-й в'їзд | Немышлянский 2-й въезд
Немишлянський 3-й в'їзд | Немышлянский 3-й въезд
Немишлянський 5-й в'їзд | Немышлянский 5-й въезд
Немишлянський 6-й в'їзд | Немышлянский 6-й въезд
Нескучна вулиця | Нескучная улица
Нескучний провулок | Нескучный переулок
Нескучний 1-й в'їзд | Нескучный 1-й въезд
Нескучний 2-й в'їзд | Нескучный 2-й въезд
Нестерова вулиця | Нестерова улица
Нетіченська вулиця | Нетеченская улица
Нетіченська набережна | Нетеченская набережная
Нетіченський провулок | Нетеченский переулок
Нетіченський бульвар | Нетеченский бульвар
Неходи Івана провулок | Неходы Ивана переулок
Нечаївський провулок | Нечаевский переулок
Нечуя-Левицького вулиця | Нечуй-Левицкого улица
Нємкіна вулиця | Немкина улица
Нижегородська вулиця | Нижегородская улица
Нижньогиївський 1-й узвіз | Нижнегиевский 1-й спуск
Нижньогиївський 2-й узвіз | Нижнегиевский 2-й спуск
Нижньогиївський 2-й в'їзд | Нижнегиевский 2-й въезд
Нижньогиївський 3-й узвіз | Нижнегиевский 3-й спуск
Нижньогиївський 4-й узвіз | Нижнегиевский 4-й спуск
Нижньогиївський 5-й узвіз | Нижнегиевский 5-й спуск
Нижньогиївський 6-й узвіз | Нижнегиевский 6-й спуск
Нижня вулиця | Нижняя улица
Нижня Гиївська вулиця | Нижнегиевская улица
Нижня Сокільницька вулиця | Нижняя Сокольническая улица
Низова вулиця | Низовая улица
Никонівська вулиця | Никоновская улица
Никонівський провулок | Никоновский переулок
Никонівський проїзд | Никоновский проезд
Ніжинська вулиця | Нежинская улица
Ніжинський провулок | Нежинский переулок
Ніжинський в'їзд | Нежинский въезд
Нікітіна вулиця | Никитина улица
Нікітіної Галини вулиця | Никитиной Галины улица
Ніколаєва вулиця | Николаева улица
Ніколаєва провулок | Николаева переулок
Нова вулиця | Новая улица
Нова Бочанська вулиця | Новая Бочанская улица
Нова Відрадненська вулиця | Новая Отрадненская улица
Нова Помірчанська вулиця | Новая Померчанская улица
Нова Чуйківська вулиця | Новая Чуйковская улица
Новгородська вулиця | Новгородская улица
Новий Побут вулиця | Новый Быт улица
Новий Побут провулок | Новый Быт переулок
Новий 1-й провулок | Новый 1-й переулок
Новиківський провулок | Новиковский переулок
Новицька вулиця | Новицкая улица
Новицький провулок | Новицкий переулок
Ново-Баварський проспект | Ново-Баварский проспект
Новобакинська вулиця | Новобакинская улица
Ново-Віринська вулиця | Ново-Веринская улица
Ново-Воскобійницька вулиця | Ново-Воскобойницкая улица
Новодаргомижська вулиця | Новодаргомыжская улица
Новодесятисажнева вулиця | Новодесятисаженная улица
Новожанівська вулиця | Новожановская улица
Новожанівський провулок | Новожановский переулок
Новожанівський в'їзд | Новожановский въезд
Новоісаївський провулок | Новоисаевский переулок
Новоконопляний провулок | Новоконопляный переулок
Новомирна вулиця | Новомирная улица
Новомирський провулок | Новомирский переулок
Новомосковська вулиця | Новомосковская улица
Новом'ясницька вулиця | Новомясницкая улица
Новонабережна вулиця | Новонабережная улица
Новоолександрівська вулиця | Новоалександровская улица
Новоолександрівський провулок | Новоалександровский переулок
Новоолексіївська вулиця | Новоалексеевская улица
Новоприміська вулиця | Новопригородная улица
Новоприміський проїзд | Новопригородный проезд
Новоприміський провулок | Новопригородный переулок
Новоприміський 1-й проїзд | Новопригородный 1-й проезд
Новоприміський 2-й в'їзд | Новопригородный 2-й въезд
Новоприміський 2-й проїзд | Новопригородный 2-й проезд
Новоприміський 3-й проїзд | Новопригородный 3-й проезд
Новопроектна вулиця | Новопроектная улица
Новопрудна вулиця | Новопрудная улица
Новоросійський провулок | Новороссийский переулок
Новорубанівський провулок | Новорубановский переулок
Ново-Румянцівська вулиця | Ново-Румянцевская улица
Ново-Садова вулиця | Ново-Садовая улица
Новоселищна вулиця | Новопоселковая улица
Новоселищний провулок | Новопоселковый переулок
Новоселищний проїзд | Новопоселковый проезд
Новоселівська вулиця | Новоселовская улица
Новоселівський провулок | Новоселовский переулок
Новосибірська вулиця | Новосибирская улица
Ново-Солонецька вулиця | Ново-Солонецкая улица
Ново-Солонецький провулок | Ново-Солонецкий переулок
Ново-Толкачівський провулок | Ново-Толкачевский переулок
Новохарківська вулиця | Новохарьковская улица
Новохатська вулиця | Новохатская улица
Новочеркаська вулиця | Новочеркасская улица
Новочеркаський провулок | Новочеркасский переулок
Ново-Чуніхінський проїзд | Ново-Чунихинский проезд
Новошишківська вулиця | Новошишковская улица
Новошишківський в'їзд | Новошишковский въезд
Новошишківський провулок | Новошишковский переулок
Ногайський провулок | Ногайский переулок
Ньютона в'їзд | Ньютона въезд
Ньютона вулиця | Ньютона улица
Обоянська вулиця | Обоянская улица
Обреїмова вулиця | Обреимова улица
Обхідний провулок | Обходной переулок
Овражна вулиця | Овражная улица
Овражний провулок | Овражный переулок
Огарівська вулиця | Огаревская улица
Одеська вулиця | Одесская улица
Одинадцятого Липня вулиця | Одиннадцатого Июля улица
Одинадцятого Липня в'їзд | Одиннадцатого Июля въезд
Одоєвський провулок | Одоевский переулок
Озерна вулиця | Озерная улица
Озерянська вулиця | Озерянская улица
Озерянський провулок | Озерянский переулок
Океанський провулок | Океанский переулок
Окружний в'їзд | Окружной въезд
Оксамитовий провулок | Бархатный переулок
Олександра Бабкіна провулок | Александра Бабкина переулок
Олександра Натієва провулок | Александра Натиева переулок
Олександра Невського майдан | Александра Невского площадь
Олександра Невського вулиця | Александра Невского улица
Олександра Шпейєра вулиця | Александра Шпейера улица
Олександри Бєлової вулиця | Александры Беловой улица
Олександрівський майдан | Александровская площадь
Олександрівський проспект | Александровский проспект
Олександрівський провулок | Александровский переулок
Олексіївська вулиця | Алексеевская улица
Олексіївський 1-й в'їзд | Алексеевский 1-й въезд
Олексіївський 2-й в'їзд | Алексеевский 2-й въезд
Оленінська вулиця | Еленинская улица
Олеся Гончара вулиця | Олеся Гончара улица
Олійняківська вулиця | Олейняковская улица
Олімпійська вулиця | Олимпийская улица
Ольгінська вулиця | Ольгинская улица
Ольгінський в'їзд | Ольгинский въезд
Омелянівський провулок | Емельяновский переулок
Омська вулиця | Омская улица
Омський в'їзд | Омский въезд
Омський 1-й в'їзд | Омский 1-й въезд
Омський 1-й провулок | Омский 1-й переулок
Омський 2-й провулок | Омский 2-й переулок
Омський 2-й в'їзд | Омский 2-й въезд
Онезька вулиця | Онежская улица
Онищенківський провулок | Онищенковский переулок
Оранжерейна вулиця | Оранжерейная улица
Орача вулиця | Пахаря улица
Орача провулок | Пахаря переулок
Оренбурзька вулиця | Оренбургская улица
Орєшкова вулиця | Орешкова улица
Орільський провулок | Орельский переулок
Оріхівська вулиця | Ореховская улица
Орловська вулиця | Орловская улица
Орловський провулок | Орловский переулок
Орловський 1-й проїзд | Орловский 1-й проезд
Орловський 2-й проїзд | Орловский 2-й проезд
Орська вулиця | Орская улица
Орський 1-й провулок | Орский 1-й переулок
Орський 2-й провулок | Орский 2-й переулок
Оршанський провулок | Оршанский переулок
Освітянська вулиця | Освитянская улица
Осетинська вулиця | Осетинская улица
Осетинський провулок | Осетинский переулок
Осетинський проїзд | Осетинский проезд
Осикова вулиця | Осиновая улица
Осипенко провулок | Осипенко переулок
Осипенко проїзд | Осипенко проезд
Осипенко вулиця | Осипенко улица
Осиповського вулиця | Осиповского улица
Осінній провулок | Осенний переулок
Оскільська вулиця | Оскольская улица
Оскільський провулок | Оскольский переулок
Основ'янська вулиця | Основянская улица
Основ'янська набережна | Основянская набережная
Основ'янський провулок | Основянский переулок
Основ'янський в'їзд | Основянский въезд
Остапа Вишні вулиця | Остапа Вишни улица
Остапа Вишні в'їзд | Остапа Вишни въезд
Острівна вулиця | Островная улица
Острогозька вулиця | Острогожская улица
Остроградський провулок | Остроградский переулок
Отакара Яроша провулок | Отакара Яроша переулок
Отакара Яроша вулиця | Отакара Яроша улица
Офіцерська вулиця | Офицерская улица
Охотська вулиця | Охотская улица
Охтинська вулиця | Охтинская улица
Охтинський провулок | Охтинский переулок
Охтирська вулиця | Ахтырская улица
Очаківська вулиця | Очаковская улица
Очаківський провулок | Очаковский переулок
Очеретянська набережна | Очеретянская набережная
Ощєпкова вулиця | Ощепкова улица
Павла Копняєва вулиця | Павла Копняева улица
Павла Копняєва проїзд | Павла Копняева проезд
Павла Копняєва провулок | Павла Копняева переулок
Павла Скоропадського вулиця | Павла Скоропадского улица
Павленківська вулиця | Павленковская улица
Павленківський в'їзд | Павленковский въезд
Павленківський провулок | Павленковский переулок
Павлівська вулиця | Павловская улица
Павлівський майдан | Павловская площадь
Палладіна вулиця | Палладина улица
Панаса Мирного провулок | Панаса Мирного переулок
Панасівський проїзд | Панасовский проезд
Панасій Яр вулиця | Панасий Яр улица
Пантелеймонівська вулиця | Пантелеймоновская улица
Панфілівців вулиця | Панфиловцев улица
Панютинський провулок | Панютинский переулок
Парашутистів вулиця | Парашютистов улица
Паркова вулиця | Парковая улица
Парниківський провулок | Парниковский переулок
Паровозна вулиця | Паровозная улица
Партизанська вулиця | Партизанская улица
Партизанський провулок | Партизанский переулок
Патріотичний в'їзд | Патриотический въезд
Пащенківська вулиця | Пащенковская улица
Переїзна вулиця | Переездная улица
Перекопська вулиця | Перекопская улица
Перекопський провулок | Перекопский переулок
Перемоги проспект | Победы проспект
Перемоги провулок | Победы переулок
Переможна вулиця | Победоносная улица
Переможців провулок | Победителей переулок
Переможців вулиця | Победителей улица
Перехресна вулиця | Перекрестная улица
Переяславська вулиця | Переяславская улица
Переяславський провулок | Переяславский переулок
Пермська вулиця | Пермская улица
Пермський провулок | Пермский переулок
Перовської вулиця | Перовской улица
Першого Травня вулиця | Первого Мая улица
Першого Травня майдан | Первого Мая площадь
Першого Травня в'їзд | Первого Мая въезд
Першотравневий провулок | Первомайский переулок
Пестеля вулиця | Пестеля улица
Пестрікова вулиця | Пестрикова улица
Петра Болбочана вулиця | Петра Болбочана улица
Петра Григоренка проспект | Петра Григоренко проспект
Петра Тронька провулок | Петра Тронько переулок
Петра Тронька вулиця | Петра Тронько улица
Петрашівський провулок | Петрашевский переулок
Петренківська вулиця | Петренковская улица
Петренківський 1-й в'їзд | Петренковский 1-й въезд
Петренківський 1-й провулок | Петренковский 1-й переулок
Петренківський 1-й проїзд | Петренковский 1-й проезд
Петренківський 2-й проїзд | Петренковский 2-й проезд
Петренківський 2-й в'їзд | Петренковский 2-й въезд
Петренківський 3-й провулок | Петренковский 3-й переулок
Петренківський 3-й проїзд | Петренковский 3-й проезд
Петренківський 4-й проїзд | Петренковский 4-й проезд
Петрівський провулок | Петровский переулок
Петрозаводська вулиця | Петрозаводская улица
Петрозаводський провулок | Петрозаводский переулок
Печенізька вулиця | Печенежская улица
Печерська вулиця | Печерская улица
Печерський провулок | Печерский переулок
Пєшкова вулиця | Пешкова улица
Пилипівська вулиця | Филипповская улица
Пильчикова вулиця | Пильчикова улица
Пирогова вулиця | Пирогова улица
Писарєва вулиця | Писарева улица
Писемського провулок | Писемского переулок
Писемського вулиця | Писемского улица
Пискунівська вулиця | Пискуновская улица
Пискунівський провулок | Пискуновский переулок
Південна вулиця | Южная улица
Південнопроектна вулиця | Южнопроектная улица
Північна вулиця | Северная улица
Північний провулок | Северный переулок
Північнокавказька вулиця | Северо-Кавказская улица
Північнокавказький в'їзд | Северо-Кавказский въезд
Підборівська вулиця | Пидборивская улица
Підвітряний провулок | Подветренный переулок
Підгірна вулиця | Подгорная улица
Підгірний 1-й в'їзд | Подгорный 1-й въезд
Підгірний 2-й в'їзд | Подгорный 2-й въезд
Підгородній проїзд | Подгородний проезд
Підйомна вулиця | Подъемная улица
Підлісна вулиця | Подлесная улица
Підривний провулок | Подрывной переулок
Підшипникова вулиця | Подшипниковая улица
Підшипниковий провулок | Подшипниковый переулок
Пілотів провулок | Пилотов переулок
Пілотів проїзд | Пилотов проезд
Пісочинська вулиця | Песочинская улица
Пісочинський в'їзд | Песочинский въезд
Піхотна вулиця | Пехотная улица
Піхотний провулок | Пехотный переулок
Піщана набережна | Песчаная набережная
Піщана вулиця | Песчаная улица
Піщаний в'їзд | Песчаный въезд
Піщаний провулок | Песчаный переулок
Піщаний 1-й в'їзд | Песчаный 1-й въезд
Піщаний 2-й в'їзд | Песчаный 2-й въезд
Планерна вулиця | Планерная улица
Планерний провулок | Планерный переулок
Планетна вулиця | Планетная улица
Планова вулиця | Плановая улица
Плановий провулок | Плановый переулок
Пластичний провулок | Пластичный переулок
Плетнівський провулок | Плетневский переулок
Плеханівська вулиця | Плехановская улица
Плеханівський провулок | Плехановский переулок
Плиткова вулиця | Плиточная улица
Плитковий тупик | Плиточный тупик
Плитковий в'їзд | Плиточный въезд
Плитковий проїзд | Плиточный проезд
Плитковий провулок | Плиточный переулок
Плідна вулиця | Плодородная улица
Плідний провулок | Плодородный переулок
Плідний 1-й провулок | Плодородный 1-й переулок
Плодовий в'їзд | Плодовый въезд
Погорілка вулиця | Погорелко улица
Погорілка провулок | Погорелко переулок
Подільський в'їзд | Подольский въезд
Подільський провулок | Подольский переулок
Поезії майдан | Поэзии площадь
Пожарського вулиця | Пожарского улица
Поздовжня вулиця | Продольная улица
Познанська вулиця | Познанская улица
Покотилівська вулиця | Покотиловская улица
Покотилівський провулок | Покотиловский переулок
Полежаєва вулиця | Полежаева улица
Ползунова провулок | Ползунова переулок
Полинна вулиця | Полынная улица
Полинний в'їзд | Полынный въезд
Поліграфічна вулиця | Полиграфическая улица
Поліканова вулиця | Поликанова улица
Поліський Яр вулиця | Полесский Яр улица
Половецька вулиця | Половецкая улица
Полтавська вулиця | Полтавская улица
Полтавський в'їзд | Полтавский въезд
Полтавський Шлях вулиця | Полтавский Шлях улица
Польова вулиця | Полевая улица
Польовий провулок | Полевой переулок
Польовий 1-й в'їзд | Полевой 1-й въезд
Польовий 2-й в'їзд | Полевой 2-й въезд
Полярна вулиця | Полярная улица
Помірки | Померки
Поморська вулиця | Поморская улица
Помяловського провулок | Помяловского переулок
Пономаренківська вулиця | Пономаренковская улица
Пономаренківський проїзд | Пономаренковский проезд
Пономаренківський провулок | Пономаренковский переулок
Пономаренківський в'їзд | Пономаренковский въезд
Пономарівська вулиця | Пономаревская улица
Пономарівський провулок | Пономаревский переулок
Поперечна 1-а вулиця | Поперечная 1-я улица
Попова провулок | Попова переулок
Порічкова вулиця | Поричкова улица
Портова вулиця | Портовая улица
Потебні вулиця | Потебни улица
Поштовий провулок | Почтовый переулок
Праці провулок | Труда переулок
Праці вулиця | Труда улица
Працюючих вулиця | Працюючих улица
Пржевальського вулиця | Пржевальского улица
Приамурська вулиця | Приамурская улица
Приамурський в'їзд | Приамурский въезд
Приамурський 1-й провулок | Приамурский 1-й переулок
Приамурський 2-й провулок | Приамурский 2-й переулок
Привільна вулиця | Привольная улица
Привокзальна вулиця | Привокзальная улица
Привокзальний провулок | Привокзальный переулок
Привокзальний майдан | Привокзальная площадь
Приймаківська вулиця | Приймаковская улица
Прикордонна вулиця | Пограничная улица
Примерівська вулиця | Примеровская улица
Приміська вулиця | Пригородная улица
Приміський провулок | Пригородный переулок
Приміський 5-й в'їзд | Пригородный 5-й въезд
Приміський 5-й проїзд | Пригородный 5-й проезд
Прирічкова вулиця | Приречная улица
Прирічковий 2-й провулок | Приречный 2-й переулок
Прирічковий 3-й провулок | Приречный 3-й переулок
Приходьківська вулиця | Приходьковская улица
Приходьківський провулок | Приходьковский переулок
Причепилівський провулок | Причепиловский переулок
Прогінний провулок | Прогонный переулок
Прогрес вулиця | Прогресс улица
Прогресивна вулиця | Прогрессивная улица
Прогресивний провулок | Прогрессивный переулок
Проектна вулиця | Проектная улица
Проектний в'їзд | Проектный въезд
Проїзний провулок | Проезжий переулок
Проліскова вулиця | Пролисковая улица
Пролісковий провулок | Пролисковый переулок
Променистий провулок | Променистый переулок
Промислова вулиця | Промышленная улица
Промисловий в'їзд | Промышленный въезд
Прорізна вулиця | Прорезная улица
Проскурівська вулиця | Проскуровская улица
Проспектна вулиця | Проспектная улица
Професорська вулиця | Профессорская улица
Профспілкова вулиця | Профсоюзная улица
Профспілковий бульвар | Профсоюзный бульвар
Прохолодний провулок | Прохладный переулок
Прудна вулиця | Прудная улица
Прудний в'їзд | Прудный въезд
Прудний 1-й провулок | Прудный 1-й переулок
Прудний 2-й провулок | Прудный 2-й переулок
Прудянська вулиця | Прудянская улица
Прудянський 1-й провулок | Прудянский 1-й переулок
Прудянський 2-й провулок | Прудянский 2-й переулок
Псарівський провулок | Псаревский переулок
Псковська вулиця | Псковская улица
Пулавська вулиця | Пулавская улица
Пулковська набережна | Пулковская набережная
Пулковська вулиця | Пулковская улица
Пулковський провулок | Пулковский переулок
Путивельський провулок | Путивльский переулок
Путивельський проїзд | Путивльский проезд
Путилівський провулок | Путиловский переулок
Пушкарівська вулиця | Пушкаревская улица
Пушкарівський провулок | Пушкаревский переулок
Пушкіна вулиця | Пушкина улица
Пушкінська вулиця | Пушкинская улица
Пушкінський в'їзд | Пушкинский въезд
П'ятигорський провулок | Пятигорский переулок
П'ятисотницька вулиця | Пятисотницкая улица
П'ятихатська вулиця | Пятихатская улица
Радищева вулиця | Радищева улица
Радіотехнічна вулиця | Радиотехническая улица
Радіотехнічний 1-й провулок | Радиотехнический 1-й переулок
Радіотехнічний 2-й провулок | Радиотехнический 2-й переулок
Раднянська вулиця | Раднянская улица
Раднянський в'їзд | Раднянский въезд
Радужна вулиця | Радужная улица
Раєвської вулиця | Раевской улица
Разіна вулиця | Разина улица
Райгородська вулиця | Райгородская улица
Райгородський провулок | Райгородский переулок
Райгородський 1-й провулок | Райгородский 1-й переулок
Райгородський 1-й проїзд | Райгородский 1-й проезд
Райгородський 2-й провулок | Райгородский 2-й переулок
Райрадівський провулок | Райсоветский переулок
Ранковий провулок | Ранковый переулок
Раскової вулиця | Расковой улица
Революції 1905 року узвіз | Революции 1905 года спуск
Революції 1905 року вулиця | Революции 1905 года улица
Реєстраторська вулиця | Регистраторская улица
Резервна вулиця | Резервная улица
Резервний провулок | Резервный переулок
Рекордний провулок | Рекордный переулок
Рельєфна вулиця | Рельефная улица
Ремісницький провулок | Ремесленный переулок
Республіканська вулиця | Республиканская улица
Решетєя вулиця | Решетея улица
Решетниківський провулок | Решетниковский переулок
Решетькінська вулиця | Решетькинская улица
Решетькінський провулок | Решетькинский переулок
Рєдіна вулиця | Редина улица
Рєпіна вулиця | Репина улица
Рєпінський провулок | Репинский переулок
Ржевський провулок | Ржевский переулок
Ржепішевського вулиця | Ржепишевского улица
Рибалка вулиця | Рыбалко улица
Рибасівська вулиця | Рыбасовская улица
Рибасівський в'їзд | Рыбасовский въезд
Рибасівський провулок | Рыбасовский переулок
Рибний майдан | Рыбная площадь
Рижівська вулиця | Рижовская улица
Рижівський провулок | Рижовский переулок
Ризький провулок | Рижский переулок
Риківська вулиця | Рыковская улица
Риківський в'їзд | Рыковский въезд
Рилєєва провулок | Рылеева переулок
Рилєєва вулиця | Рылеева улица
Римарська вулиця | Рымарская улица
Рівний провулок | Ровный переулок
Різдвяна вулиця | Рождественская улица
Різниківський провулок | Резниковский переулок
Річицький провулок | Речицкий переулок
Річкова вулиця | Речная улица
Річковий провулок | Речной переулок
Ріякінська вулиця | Риякинская улица
Робесп'єра вулиця | Робеспьера улица
Робесп'єра провулок | Робеспьера переулок
Робкорівська вулиця | Рабкоровская улица
Робкорівський провулок | Рабкоровский переулок
Роганська вулиця | Роганская улица
Роганський провулок | Роганский переулок
Роганський тупик | Роганский тупик
Роганський проїзд | Роганский проезд
Рогатинська Левада вулиця | Рогатинская Левада улица
Рогатинський провулок | Рогатинский переулок
Рогатинський проїзд | Рогатинский проезд
Рогозова вулиця | Рогозовая улица
Рогозовий проїзд | Рогозовый проезд
Рогозовий 1-й провулок | Рогозовый 1-й переулок
Рогозовий 2-й провулок | Рогозовый 2-й переулок
Родникова вулиця | Родниковая улица
Роздольський провулок | Раздольский переулок
Роз'їзний провулок | Разъездной переулок
Розторгуївський провулок | Расторгуевский переулок
Рокитна вулиця | Рокитная улица
Романовичівська вулиця | Романовичевская улица
Ромашкіна вулиця | Ромашкина улица
Ромашова Бориса вулиця | Ромашова Бориса улица
Ромен Роллана вулиця | Ромена Роллана улица
Роменська вулиця | Роменская улица
Роменський провулок | Роменский переулок
Роменський 1-й в'їзд | Роменский 1-й въезд
Роменський 2-й в'їзд | Роменский 2-й въезд
Росинського провулок | Росинского переулок
Росинського в'їзд | Росинского въезд
Ростовська вулиця | Ростовская улица
Ростовське шосе | Ростовское шоссе
Ротний провулок | Ротный переулок
Рохманівський провулок | Рохмановский переулок
Рубанівська вулиця | Рубановская улица
Рубанівський провулок | Рубановский переулок
Рубежанський провулок | Рубежанский переулок
Рудаківська вулиця | Рудаковская улица
Руденка провулок | Руденко переулок
Руденка вулиця | Руденко улица
Рудика вулиця | Рудика улица
Рудінська вулиця | Рудинская улица
Рудникова вулиця | Рудничная улица
Рудниковий в'їзд | Рудничный въезд
Рудниковий 1-й провулок | Рудничный 1-й переулок
Рудниковий 2-й провулок | Рудничный 2-й переулок
Рудниковий 3-й провулок | Рудничный 3-й переулок
Румянцівська вулиця | Румянцевская улица
Румянцівський провулок | Румянцевский переулок
Руслана Плоходька вулиця | Руслана Плоходько улица
Руставелі провулок | Руставели переулок
Руставелі вулиця | Руставели улица
Рязанська вулиця | Рязанская улица
Саблєва провулок | Саблева переулок
Саблєва вулиця | Саблева улица
Сабурівська вулиця | Сабуровская улица
Сабурівська набережна | Сабуровская набережная
Сабурівський провулок | Сабуровский переулок
Савченків провулок | Савченков переулок
Сагайдачного вулиця | Сагайдачного улица
Садибна вулиця | Усадебная улица
Садибний в'їзд | Усадебный въезд
Садівницький провулок | Садовнический переулок
Садова вулиця | Садовая улица
Садовий бульвар | Садовый бульвар
Садовий проїзд | Садовый проезд
Садовий провулок | Садовый переулок
Садовий 1-й в'їзд | Садовый 1-й въезд
Садовий 2-й в'їзд | Садовый 2-й въезд
Садовий 3-й в'їзд | Садовый 3-й въезд
Садовонабережна вулиця | Садовонабережная улица
Садовопаркова вулиця | Садовопарковая улица
Садовських провулок | Садовских переулок
Саксаганського вулиця | Саксаганского улица
Саксаганського провулок | Саксаганского переулок
Салтикова-Щедріна вулиця | Салтыкова-Щедрина улица
Салтівське шосе | Салтовское шоссе
Салтівський провулок | Салтовский переулок
Самаркандська вулиця | Самаркандская улица
Самаркандський провулок | Самаркандский переулок
Самаркандський 1-й в'їзд | Самаркандский 1-й въезд
Самаркандський 2-й в'їзд | Самаркандский 2-й въезд
Самарська вулиця | Самарская улица
Самодіяльна вулиця | Самодеятельная улица
Самокіша вулиця | Самокиша улица
Самокіша провулок | Самокиша переулок
Самсонівська вулиця | Самсоновская улица
Санаторний в'їзд | Санаторный въезд
Санжарівська вулиця | Санжаревская улица
Санжарівський провулок | Санжаревский переулок
Саперна вулиця | Саперная улица
Саперний провулок | Саперный переулок
Саранський в'їзд | Саранский въезд
Саратовська вулиця | Саратовская улица
Саратовський в'їзд | Саратовский въезд
Саржинка вулиця | Саржинка улица
Саржинська вулиця | Саржинская улица
Сахалінська вулиця | Сахалинская улица
Сахновщанська вулиця | Сахновщинская улица
Сватівська вулиця | Сватовская улица
Свинаренка Петра вулиця | Свинаренко Петра улица
Свистуна вулиця | Свистуна улица
Свистунівська вулиця | Свистуновская улица
Свідзінського вулиця | Свидзинского улица
Свідзінського 1-й провулок | Свидзинского 1-й переулок
Свідзінського 2-й провулок | Свидзинского 2-й переулок
Свірська вулиця | Свирская улица
Світанкова вулиця | Свитанковая улица
Світла вулиця | Светлая улица
Світланівська вулиця | Светлановская улица
Світло Шахтаря вулиця | Свет Шахтера улица
Світло Шахтаря провулок | Свет Шахтера переулок
Свободи майдан | Свободы площадь
Свободи вулиця | Свободы улица
Святодухівська вулиця | Святодуховская улица
Севастопольська вулиця | Севастопольская улица
Северина Потоцького провулок | Северина Потоцкого переулок
Северина Потоцького вулиця | Северина Потоцкого улица
Селекційна вулиця | Селекционная улица
Селіванова вулиця | Селиванова улица
Селянська вулиця | Селянская улица
Селянський провулок | Селянский переулок
Селянський в'їзд | Селянский въезд
Семафорна вулиця | Семафорная улица
Семафорний в'їзд | Семафорный въезд
Семафорний провулок | Семафорный переулок
Семафорний проїзд | Семафорный проезд
Семена Кузнеця вулиця | Семена Кузнеца улица
Семена Кузнеця провулок | Семена Кузнеца переулок
Семенівський провулок | Семеновский переулок
Семиградська вулиця | Семиградская улица
Семиградський провулок | Семиградский переулок
Семиградський в'їзд | Семиградский въезд
Семінарська вулиця | Семинарская улица
Семка вулиця | Семко улица
Сенявіна вулиця | Сенявина улица
Сепараторний проїзд | Сепараторный проезд
Серафімовича провулок | Серафимовича переулок
Серафімовича вулиця | Серафимовича улица
Сергіївська вулиця | Сергиевская улица
Сергіївський майдан | Сергиевская площадь
Сергія Дрімцова вулиця | Сергея Дремцова улица
Серебряківська вулиця | Серебряковская улица
Серебряківський провулок | Серебряковский переулок
Серебрякової вулиця | Серебряковой улица
Середівська вулиця | Середивская улица
Середньоуральська вулиця | Среднеуральская улица
Середньоуральський провулок | Среднеуральский переулок
Середньоуральський в'їзд | Среднеуральский въезд
Середня Сокільницька вулиця | Средняя Сокольническая улица
Сержантська вулиця | Сержантская улица
Сержантський провулок | Сержантский переулок
Серпова вулиця | Серповая улица
Сестрорецький провулок | Сестрорецкий переулок
Сеченова вулиця | Сеченова улица
Сєдова провулок | Седова переулок
Сєдова вулиця | Седова улица
Сибірська вулиця | Сибирская улица
Сибірський провулок | Сибирский переулок
Сиваська вулиця | Сивашская улица
Сиваський провулок | Сивашский переулок
Сидельниківський провулок | Сидельниковский переулок
Сидоренківська вулиця | Сидоренковская улица
Сидоренківський провулок | Сидоренковский переулок
Сизранський провулок | Сызранский переулок
Симиренків провулок | Симиренков переулок
Синельникова провулок | Синельникова переулок
Сичівський провулок | Сычевский переулок
Сичівський 1-й в'їзд | Сычевский 1-й въезд
Сичівський 2-й в'їзд | Сычевский 2-й въезд
Сіверська вулиця | Сиверская улица
Сіверськодонецька вулиця | Северо-Донецкая улица
Сіверськодонецький провулок | Северо-Донецкий переулок
Сіверськодонецький в'їзд | Северо-Донецкий въезд
Сількорівський провулок | Селькоровский переулок
Сільський в'їзд | Сельский въезд
Сільськогосподарська вулиця | Сельскохозяйственная улица
Сімферопольська вулиця | Симферопольская улица
Сімферопольський провулок | Симферопольский переулок
Сінна вулиця | Сенная улица
Сінний 1-й провулок | Сенной 1-й переулок
Сінний 2-й провулок | Сенной 2-й переулок
Сінний 3-й провулок | Сенной 3-й переулок
Сіриківська вулиця | Сериковская улица
Сіриківський проїзд | Сериковский проезд
Сіриківський провулок | Сериковский переулок
Січовий провулок | Сечевой переулок
Січових Стрільців вулиця | Сечевых Стрельцов улица
Скадовського провулок | Скадовского переулок
Скачкова вулиця | Скачкова улица
Скобелевська вулиця | Скобелевская улица
Сковородинівська вулиця | Сковородиновская улица
Сковородинівський провулок | Сковородиновский переулок
Сковородинівський в'їзд | Сковородиновский въезд
Скрипаївська вулиця | Скрипаевская улица
Скрипника вулиця | Скрыпника улица
Скурідіна Дача вулиця | Скуридина Дача улица
Слави проспект | Славы проспект
Слатіна вулиця | Слатина улица
Сливовий провулок | Сливовый переулок
Слобожанська вулиця | Слобожанская улица
Словацький провулок | Словацкий переулок
Слов'янська вулиця | Славянская улица
Службова вулиця | Служебная улица
Слюсарний провулок | Слесарный переулок
Смарагдовий провулок | Изумрудный переулок
Смирнівська вулиця | Смирновская улица
Смілянська вулиця | Смелянская улица
Смілянська 1-а вулиця | Смелянская 1-я улица
Смілянська 2-а вулиця | Смелянская 2-а улица
Смілянський проїзд | Смелянский проезд
Смоленська вулиця | Смоленская улица
Смоленський провулок | Смоленский переулок
Смольна вулиця | Смольная улица
Снегіревський провулок | Снегиревский переулок
Сніжківська вулиця | Снежковская улица
Собінова вулиця | Собинова улица
Соборний узвіз | Соборный спуск
Соборний провулок | Соборный переулок
Соїча вулиця | Соича улица
Сокільники | Сокольники
Сокільницька вулиця | Сокольническая улица
Сокільницький проїзд | Сокольнический проезд
Сокільницький 1-й в'їзд | Сокольнический 1-й въезд
Сокільницький 2-й в'їзд | Сокольнический 2-й въезд
Сокільницький 3-й в'їзд | Сокольнический 3-й въезд
Соколовська вулиця | Соколовская улица
Соколовський провулок | Соколовский переулок
Солдатська вулиця | Солдатская улица
Солдатський провулок | Солдатский переулок
Солонецький проїзд | Солонецкий проезд
Солоницівська вулиця | Солоницевская улица
Солоницівський провулок | Солоницевский переулок
Соляниківський провулок | Соляниковский переулок
Сомівська вулиця | Сомовская улица
Сонячна вулиця | Солнечная улица
Сонячногірська вулиця | Солнечногорская улица
Соняшникова вулиця | Подсолнечная улица
Соняшниковий провулок | Подсолнечный переулок
Соняшниковий в'їзд | Подсолнечный въезд
Сорочинська вулиця | Сорочинская улица
Сортувальний провулок | Сортировочный переулок
Соснова вулиця | Сосновая улица
Софіївська вулиця | Софиевская улица
Сохора вулиця | Сохора улица
Сочинська вулиця | Сочинская улица
Спартака вулиця | Спартака улица
Спартаківський провулок | Спартаковский переулок
Спиридонівська вулиця | Спиридоновская улица
Спортивна вулиця | Спортивная улица
Спортивний провулок | Спортивный переулок
Срезневського вулиця | Срезневского улица
Срезневського в'їзд | Срезневского въезд
Срібна вулиця | Серебряная улица
Стадіонний проїзд | Стадионный проезд
Станіславського провулок | Станиславского переулок
Станційна вулиця | Станционная улица
Станційний в'їзд | Станционный въезд
Стара Відрадненська вулиця | Старая Отрадненская улица
Стара Озерянка вулиця | Старая Озерянка улица
Старий Куток вулиця | Старый Куток улица
Старицького вулиця | Старицкого улица
Старобільський провулок | Старобельский переулок
Старова вулиця | Старова улица
Староверещаківська вулиця | Староверещаковская улица
Староверещаківський 2-й в'їзд | Староверещаковский 2-й въезд
Старовський 1-й в'їзд | Старовский 1-й въезд
Старо-Григорівська вулиця | Старо-Григоровская улица
Старо-Григорівський провулок | Старо-Григоровский переулок
Стародесятисажнева вулиця | Стародесятисаженная улица
Стародубська вулиця | Стародубская улица
Старо-Іскринський провулок | Старо-Искринский переулок
Старо-Кримська вулиця | Старо-Крымская улица
Старо-Кримський 1-й провулок | Старо-Крымский 1-й переулок
Старо-Кримський 2-й провулок | Старо-Крымский 2-й переулок
Старомалооснов'янська вулиця | Старомалоосновянская улица
Старомосковський провулок | Старомосковский переулок
Старопрудна вулиця | Старопрудная улица
Старопрудний провулок | Старопрудный переулок
Старошишківська вулиця | Старошишковская улица
Старошишківський в'їзд | Старошишковский въезд
Стартова вулиця | Стартовая улица
Старшинський в'їзд | Старшинский въезд
Стельмаха провулок | Стельмаха переулок
Степанківський провулок | Степанковский переулок
Степова вулиця | Степная улица
Степовий провулок | Степной переулок
Степовий 1-й провулок | Степной 1-й переулок
Степовий 2-й провулок | Степной 2-й переулок
Стефенсона вулиця | Стефенсона улица
Столярний провулок | Столярный переулок
Стрілецький провулок | Стрелецкий переулок
Стрілецький 1-й в'їзд | Стрелецкий 1-й въезд
Стрілецький 2-й в'їзд | Стрелецкий 2-й въезд
Стрілківка вулиця | Стрелковка улица
Струницький провулок | Струницкий переулок
Струницький в'їзд | Струницкий въезд
Студентська вулиця | Студенческая улица
Студентський провулок | Студенческий переулок
Суворова вулиця | Суворова улица
Суворова проїзд | Суворова проезд
Суворова в'їзд | Суворова въезд
Суздальські Ряди вулиця | Суздальские Ряды улица
Сумгаїтська вулиця | Сумгаитская улица
Сумська вулиця | Сумская улица
Сумцова вулиця | Сумцова улица
Сумцова провулок | Сумцова переулок
Сурикова провулок | Сурикова переулок
Сусаніна Івана провулок | Сусанина Ивана переулок
Сусаніна Івана вулиця | Сусанина Ивана улица
Сухарівська вулиця | Сухаревская улица
Сухарівський провулок | Сухаревский переулок
Сухумська вулиця | Сухумская улица
Сучасна вулиця | Сучасная улица
Сущенська вулиця | Сущенская улица
Східна вулиця | Восточная улица
Східний провулок | Восточный переулок
Сьомої Гвардійської Армії вулиця | Седьмой Гвардейской Армии улица
Таборова вулиця | Лагерная улица
Таборовий проїзд | Лагерный проезд
Таборовий 2-й провулок | Лагерный 2-й переулок
Таборовий 3-й провулок | Лагерный 3-й переулок
Таборовий 4-й провулок | Лагерный 4-й переулок
Таганський провулок | Таганский переулок
Таганський 1-й провулок | Таганский 1-й переулок
Таганський 2-й провулок | Таганский 2-й переулок
Таганський 3-й провулок | Таганский 3-й переулок
Тагільська вулиця | Тагильская улица
Тагільський провулок | Тагильский переулок
Таджицька вулиця | Таджикская улица
Таймирська вулиця | Таймырская улица
Танєєва провулок | Танеева переулок
Танкова вулиця | Танковая улица
Танкопія вулиця | Танкопия улица
Танкопія провулок | Танкопия переулок
Таранушенка вулиця | Таранушенко улица
Таранушенка в'їзд | Таранушенко въезд
Тарасівська вулиця | Тарасовская улица
Тарасівський провулок | Тарасовский переулок
Тарасівський в'їзд | Тарасовский въезд
Таращанська вулиця | Таращанская улица
Тархова вулиця | Тархова улица
Тахіатаська вулиця | Тахиаташская улица
Ташкентська вулиця | Ташкентская улица
Ташкентський провулок | Ташкентский переулок
Тбіліський провулок | Тбилисский переулок
Тваринників вулиця | Животноводов улица
Тверська вулиця | Тверская улица
Театральний майдан | Театральная площадь
Театральний провулок | Театральный переулок
Теплична вулиця | Тепличная улица
Тепловозна вулиця | Тепловозная улица
Терихівська вулиця | Териховская улица
Тернова вулиця | Терновая улица
Терновий провулок | Терновый переулок
Терновий Яр вулиця | Терновый Яр улица
Терновий 1-й проїзд | Терновый 1-й проезд
Терновий 2-й проїзд | Терновый 2-й проезд
Терновий 3-й проїзд | Терновый 3-й проезд
Тернопільська вулиця | Тернопольская улица
Тернопольський в'їзд | Тернопольский въезд
Тетяни Устинової провулок | Татьяны Устиновой переулок
Тетянівський провулок | Татьяновский переулок
Технічна вулиця | Техническая улица
Технічний провулок | Технический переулок
Технологічний в'їзд | Технологический въезд
Тираспільська вулиця | Тираспольская улица
Тираспільський провулок | Тираспольский переулок
Тираспільський 1-й в'їзд | Тираспольский 1-й въезд
Тираспільський 2-й в'їзд | Тираспольский 2-й въезд
Тираспільський 3-й в'їзд | Тираспольский 3-й въезд
Тираспільський 4-й в'їзд | Тираспольский 4-й въезд
Тираспольський в'їзд | Тираспольский въезд
Тисова вулиця | Тисовая улица
Титаренківський провулок | Титаренковский переулок
Тиха вулиця | Тихая улица
Тиха Друга вулиця | Тихая Вторая улица
Тиха Перша вулиця | Тихая Первая улица
Тиха Третя вулиця | Тихая Третья улица
Тиха Четверта вулиця | Тихая Четвертая улица
Тихий провулок | Тихий переулок
Тихий проїзд | Тихий проезд
Тихий Восьмий провулок | Тихий Восьмой переулок
Тихий Другий провулок | Тихий Второй переулок
Тихий Перший провулок | Тихий Первый переулок
Тихий П'ятий провулок | Тихий Пятый переулок
Тихий Сьомий провулок | Тихий Седьмой переулок
Тихий Третій провулок | Тихий Третий переулок
Тихий Четвертий провулок | Тихий Четвертый переулок
Тихий Шостий провулок | Тихий Шестой переулок
Тишківський проїзд | Тишковский проезд
Тищенківська вулиця | Тищенковская улица
Тищенківський проїзд | Тищенковский проезд
Тімірязєва провулок | Тимирязева переулок
Тімірязєва вулиця | Тимирязева улица
Тімірязєва в'їзд | Тимирязева въезд
Тіниста вулиця | Тенистая улица
Тінистий провулок | Тенистый переулок
Тітова вулиця | Титова улица
Ткаченківська вулиця | Ткаченковская улица
Ткаченківський провулок | Ткаченковский переулок
Ткаченківський в'їзд | Ткаченковский въезд
Ткачівська вулиця | Ткачевская улица
Тобольська вулиця | Тобольская улица
Товариська вулиця | Товарищеская улица
Товариський провулок | Товарищеский переулок
Токарівський провулок | Токаревский переулок
Толбухіна вулиця | Толбухина улица
Толкачівський в'їзд | Толкачевский въезд
Толстого вулиця | Толстого улица
Томахівський провулок | Томаховский переулок
Томська вулиця | Томская улица
Томський провулок | Томский переулок
Тополева вулиця | Тополевая улица
Тополина вулиця | Тополиная улица
Топчіївський провулок | Топчиевский переулок
Торгова вулиця | Торговая улица
Торговий в'їзд | Торговый въезд
Торговий проїзд | Торговый проезд
Травневий проїзд | Майский проезд
Трав'яний провулок | Травяной переулок
Тракторна вулиця | Тракторная улица
Тракторний 1-й провулок | Тракторный 1-й переулок
Тракторобудівників проспект | Тракторостроителей проспект
Трамвайна вулиця | Трамвайная улица
Трансформаторна вулиця | Трансформаторная улица
Трансформаторний провулок | Трансформаторный переулок
Трансформаторний проїзд | Трансформаторный проезд
Третя вулиця | Третья улица
Трипільський провулок | Трипольский переулок
Трінклера в'їзд | Тринклера въезд
Трінклера вулиця | Тринклера улица
Троїцький провулок | Троицкий переулок
Тролейбусна вулиця | Троллейбусная улица
Тропініна вулиця | Тропинина улица
Тростянецький провулок | Тростянецкий переулок
Трохимівський провулок | Трофимовский переулок
Троценка вулиця | Троценко улица
Трубна вулиця | Трубная улица
Трубний провулок | Трубный переулок
Трубний в'їзд | Трубный въезд
Трудова вулиця | Трудовая улица
Трудовий провулок | Трудовой переулок
Труфанова вулиця | Труфанова улица
Тульська вулиця | Тульская улица
Тульський провулок | Тульский переулок
Тульчинський провулок | Тульчинский переулок
Тупий провулок | Тупой переулок
Турбінна вулиця | Турбинная улица
Турбінний проїзд | Турбинный проезд
Турбогенераторна вулиця | Турбогенераторная улица
Тургенівська вулиця | Тургеневская улица
Тургенівський провулок | Тургеневский переулок
Туркестанська вулиця | Туркестанская улица
Туркестанський провулок | Туркестанский переулок
Тюленіна Сергія вулиця | Тюленина Сергея улица
Тюменський провулок | Тюменский переулок
Тюрінська вулиця | Тюринская улица
Тюрінський узвіз | Тюринский спуск
Тяньшаньська вулиця | Тяньшаньская улица
Углицький провулок | Угличский переулок
Уграїцького провулок | Уграицкого переулок
Уграїцького вулиця | Уграицкого улица
Ударний в'їзд | Ударный въезд
Удмуртська вулиця | Удмуртская улица
Удмуртський провулок | Удмуртский переулок
Удянська вулиця | Удянская улица
Удянський в'їзд | Удянский въезд
Удянський провулок | Удянский переулок
Удянський проїзд | Удянский проезд
Удянський 1-й в'їзд | Удянский 1-й въезд
Удянський 2-й в'їзд | Удянский 2-й въезд
Ужвій Наталії вулиця | Ужвий Натальи улица
Ужгородський проїзд | Ужгородский проезд
Узбецький провулок | Узбекский переулок
Українська вулиця | Украинская улица
Уманська вулиця | Уманская улица
Унецький провулок | Унечский переулок
Університетська вулиця | Университетская улица
Університетський провулок | Университетский переулок
Університетський 2-й провулок | Университетский 2-й переулок
Уральська вулиця | Уральская улица
Уральський провулок | Уральский переулок
Урожайна вулиця | Урожайная улица
Урюпіна вулиця | Урюпина улица
Усівський провулок | Усовский переулок
Усівський 2-й в'їзд | Усовский 2-й въезд
Усівський 3-й в'їзд | Усовский 3-й въезд
Уссурійська вулиця | Уссурийская улица
Учительський провулок | Учительский переулок
Ушакова вулиця | Ушакова улица
Ушинського провулок | Ушинского переулок
Ушинського вулиця | Ушинского улица
Фанінський провулок | Фанинский переулок
Фасадна вулиця | Фасадная улица
Фастівський провулок | Фастовский переулок
Федецького вулиця | Федецкого улица
Федецького в'їзд | Федецкого въезд
Федоренка вулиця | Федоренко улица
Федоренка провулок | Федоренко переулок
Федорівська вулиця | Федоровская улица
Федорцівська вулиця | Федорцовская улица
Федорцівський провулок | Федорцовский переулок
Фейєрбаха вулиця | Фейербаха улица
Фейєрбаха майдан | Фейербаха площадь
Фейєрбаха провулок | Фейербаха переулок
Фельдшерська вулиця | Фельдшерская улица
Феодосійська вулиця | Феодосийская улица
Ферганська вулиця | Ферганская улица
Ферганський провулок | Ферганский переулок
Фермерська вулиця | Фермерская улица
Фесенківська вулиця | Фесенковская улица
Фесенківський в'їзд | Фесенковский въезд
Фестивальна вулиця | Фестивальная улица
Фестивальний провулок | Фестивальный переулок
Фізкультурна вулиця | Физкультурная улица
Фізкультурний в'їзд | Физкультурный въезд
Фізкультурний провулок | Физкультурный переулок
Фіґнер вулиця | Фигнер улица
Фіньківський провулок | Финьковский переулок
Фісановича вулиця | Фисановича улица
Фонвізіна вулиця | Фонвизина улица
Франка вулиця | Франко улица
Франка провулок | Франко переулок
Франка в'їзд | Франко въезд
Франківська вулиця | Франковская улица
Франківський провулок | Франковский переулок
Франтішка Крала вулиця | Франтишека Крала улица
Фролівський провулок | Фроловский переулок
Фронтова вулиця | Фронтовая улица
Фронтовиків бульвар | Фронтовиков бульвар
Фруктовий провулок | Фруктовый переулок
Хабарова вулиця | Хабарова улица
Хабаровська вулиця | Хабаровская улица
Хабаровський провулок | Хабаровский переулок
Халтуріна провулок | Халтурина переулок
Харківська вулиця | Харьковская улица
Харківська набережна | Харьковская набережная
Харківських Дивізій вулиця | Харьковских Дивизий улица
Харченківська вулиця | Харченковская улица
Харченківський провулок | Харченковский переулок
Харченківський в'їзд | Харченковский въезд
Хасанський провулок | Хасанский переулок
Хатишевський провулок | Хатышевский переулок
Хвильового вулиця | Хвилевого улица
Хвойна вулиця | Хвойная улица
Хвойний в'їзд | Хвойный въезд
Хвощова вулиця | Хвощовая улица
Хемзівська вулиця | Хемзовская улица
Херсонська вулиця | Херсонская улица
Хімічний провулок | Химический переулок
Хліборобна вулиця | Хлеборобная улица
Холмогорська вулиця | Холмогорская улица
Холодногірська вулиця | Холодногорская улица
Холодногірський провулок | Холодногорский переулок
Хорольська вулиця | Хорольская улица
Хорошевський провулок | Хорошевский переулок
Хотомлянська вулиця | Хотомлянская улица
Храмова вулиця | Храмова улица
ХТЗ вулиця | ХТЗ улица
ХТЗ провулок | ХТЗ переулок
Хуторянська вулиця | Хуторянская улица
Хуторянський в'їзд | Хуторянский въезд
Цегельний провулок | Кирпичный переулок
Цементна вулиця | Цементная улица
Цепківська вулиця | Цепковская улица
Цехівська вулиця | Цеховская улица
Цигарівський в'їзд | Цыгаревский въезд
Цигарівський провулок | Цыгаревский переулок
Цимлянський провулок | Цимлянский переулок
Циркунівська вулиця | Циркуновская улица
Цитівська вулиця | Цитовская улица
Цілинна вулиця | Целинная улица
Цілиноградська вулиця | Целиноградская улица
Ціолковського провулок | Циолковского переулок
Ціолковського в'їзд | Циолковского въезд
Чаадаєва в'їзд | Чаадаева въезд
Чаадаєва провулок | Чаадаева переулок
Чаадаєва вулиця | Чаадаева улица
Чаадаєва 2-й в'їзд | Чаадаева 2-й въезд
Чайкіної Лізи провулок | Чайкиной Лизы переулок
Чайкіної Лізи вулиця | Чайкиной Лизы улица
Чайковська вулиця | Чайковская улица
Чаплигінський провулок | Чаплыгинский переулок
Чапліївська вулиця | Чаплиевская улица
Чапліївський провулок | Чаплиевский переулок
Чебишева провулок | Чебышева переулок
Чебишева вулиця | Чебышева улица
Чебоксарський провулок | Чебоксарский переулок
Челюскіна Семена вулиця | Челюскина Семена улица
Челюскінців в'їзд | Челюскинцев въезд
Челюскінців вулиця | Челюскинцев улица
Челюскінців 1-й в'їзд | Челюскинцев 1-й въезд
Челюскінців 2-й в'їзд | Челюскинцев 2-й въезд
Челюскінців 3-й в'їзд | Челюскинцев 3-й въезд
Челюскінців 4-й в'їзд | Челюскинцев 4-й въезд
Челябінська вулиця | Челябинская улица
Челябінський провулок | Челябинский переулок
Чепелкінська вулиця | Чепелкинская улица
Чепелкінський провулок | Чепелкинский переулок
Чепелкінський проїзд | Чепелкинский проезд
Червона вулиця | Червоная улица
Червона Алея вулиця | Красная Аллея улица
Червона Алея в'їзд | Красная Аллея въезд
Червона Алея 2-й в'їзд | Красная Аллея 2-й въезд
Червоний в'їзд | Красный въезд
Червоні Ряди вулиця | Красные Ряды улица
Червоної Троянди вулиця | Красной Розы улица
Червономаяцька вулиця | Красномаяцкая улица
Червонюка вулиця | Червонюка улица
Чередниченківський провулок | Чередниченковский переулок
Черемушна вулиця | Черемушная улица
Черемушний провулок | Черемушный переулок
Черепанових вулиця | Черепановых улица
Черкаська вулиця | Черкасская улица
Черкаський провулок | Черкасский переулок
Чернишевська вулиця | Чернышевская улица
Чернівецька вулиця | Чернивецкая улица
Чернівецький провулок | Чернивецкий переулок
Чернівецький в'їзд | Чернивецкий въезд
Чернігівська вулиця | Черниговская улица
Чернігівський провулок | Черниговский переулок
Чернігівський проїзд | Черниговский проезд
Черновський провулок | Черновский переулок
Черняховського вулиця | Черняховского улица
Черняховського провулок | Черняховского переулок
Четвертий в'їзд | Четвертый въезд
Четвертий провулок | Четвертый переулок
Чехова провулок | Чехова переулок
Чехова вулиця | Чехова улица
Чигирина Юлія вулиця | Чигирина Юлия улица
Чинбарна вулиця | Кожевенная улица
Чистоклітівська вулиця | Чистоклетовская улица
Чистоклітівський 1-й провулок | Чистоклетовский 1-й переулок
Чистоклітівський 2-й провулок | Чистоклетовский 2-й переулок
Чистякової вулиця | Чистяковой улица
Чичибабіна вулиця | Чичибабина улица
Чкалова вулиця | Чкалова улица
Чкалова провулок | Чкалова переулок
Чоботарська вулиця | Чеботарская улица
Чоботарський провулок | Чеботарский переулок
Чоботарський 1-й в'їзд | Чеботарский 1-й въезд
Чоботарський 2-й в'їзд | Чеботарский 2-й въезд
Чорноземна вулиця | Черноземная улица
Чорноморська вулиця | Черноморская улица
Чуваська вулиця | Чувашская улица
Чугуївська вулиця | Чугуевская улица
Чугуївський 1-й в'їзд | Чугуевский 1-й въезд
Чугуївський 2-й в'їзд | Чугуевский 2-й въезд
Чугуївський 3-й в'їзд | Чугуевский 3-й въезд
Чуйківська вулиця | Чуйковская улица
Чуйківський провулок | Чуйковский переулок
Чуйківський 1-й провулок | Чуйковский 1-й переулок
Чуйківський 2-й провулок | Чуйковский 2-й переулок
Чуйківський 3-й провулок | Чуйковский 3-й переулок
Чуйківський 4-й провулок | Чуйковский 4-й переулок
Чуйківський 5-й провулок | Чуйковский 5-й переулок
Чуйківський 6-й провулок | Чуйковский 6-й переулок
Чукотська вулиця | Чукотская улица
Чукотський провулок | Чукотский переулок
Чумаківський в'їзд | Чумаковский въезд
Чуніхінська вулиця | Чунихинская улица
Шалімова вулиця | Шалимова улица
Шаляпіна вулиця | Шаляпина улица
Шаповалівський провулок | Шаповаловский переулок
Шарикова вулиця | Шариковая улица
Шариковий в'їзд | Шариковый въезд
Шариковий проїзд | Шариковый проезд
Шарівський провулок | Шаровский переулок
Шатилівська вулиця | Шатиловская улица
Шатилова Дача вулиця | Шатилова Дача улица
Шахтарська вулиця | Шахтерская улица
Шацька вулиця | Шацкая улица
Шацький в'їзд | Шацкий въезд
Швидкісна вулиця | Скоростная улица
Швидкісний провулок | Скоростной переулок
Швидкісний в'їзд | Скоростной въезд
Шебелинська вулиця | Шебелинская улица
Шевченка вулиця | Шевченко улица
Шевченківський провулок | Шевченковский переулок
Шевченківський проїзд | Шевченковский проезд
Шекспіра вулиця | Шекспира улица
Шекспіра провулок | Шекспира переулок
Шепетівська вулиця | Шепетовская улица
Шепетівський провулок | Шепетовский переулок
Шилівський в'їзд | Шиловский въезд
Шилівський провулок | Шиловский переулок
Шиллінгера провулок | Шиллингера переулок
Шиллінгера вулиця | Шиллингера улица
Широніна вулиця | Широнина улица
Ширяєва вулиця | Ширяева улица
Шишківська вулиця | Шишковская улица
Шишківський провулок | Шишковский переулок
Шишкінський провулок | Шишкинский переулок
Шкільна вулиця | Школьная улица
Шкільний провулок | Школьный переулок
Шлюзова вулиця | Шлюзовая улица
Шляхопровідний провулок | Путепроводный переулок
Шмідта Лейтенанта вулиця | Шмидта Лейтенанта улица
Шмідта Отто вулиця | Шмидта Отто улица
Шмідта Отто провулок | Шмидта Отто переулок
Шовковична вулиця | Шовковичная улица
Шовковичний 3-й в'їзд | Шовковичный 3-й въезд
Шовковичний 4-й в'їзд | Шовковичный 4-й въезд
Шовковичний 5-й в'їзд | Шовковичный 5-й въезд
Шолом-Алейхема вулиця | Шолом-Алейхема улица
Шолохова провулок | Шолохова переулок
Шолохова вулиця | Шолохова улица
Шосейний в'їзд | Шоссейный въезд
Шосткінська вулиця | Шосткинская улица
Шосткінський провулок | Шосткинский переулок
Шостопарк в'їзд | Шестопарк въезд
Шостопарк вулиця | Шестопарк улица
Шостопарк провулок | Шестопарк переулок
Шпаківський провулок | Шпаковский переулок
Шполянська вулиця | Шполянская улица
Штерівська вулиця | Штеровская улица
Штурмова вулиця | Штурмовая улица
Шуберта майдан | Шуберта площадь
Шуберта вулиця | Шуберта улица
Шубнікова вулиця | Шубникова улица
Шульженко Клавдії вулиця | Шульженко Клавдии улица
Шумана провулок | Шумана переулок
Шумана вулиця | Шумана улица
Шумілова вулиця | Шумилова улица
Щаслива вулиця | Счастливая улица
Щасливий провулок | Счастливый переулок
Щедрінська вулиця | Щедринская улица
Щедрінський Квартал провулок | Щедринский Квартал переулок
Щепкіна вулиця | Щепкина улица
Щербачівський проїзд | Щербачевский проезд
Щигрівська вулиця | Щигровская улица
Щоголівська вулиця | Щеголевская улица
Щукіна вулиця | Щукина улица
Ювілейна вулиця | Юбилейная улица
Ювілейний в'їзд | Юбилейный въезд
Ювілейний проїзд | Юбилейный проезд
Ювілейний провулок | Юбилейный переулок
Ювілейний проспект | Юбилейный проспект
Югорський провулок | Югорский переулок
Юдіна вулиця | Юдина улица
Юмашева вулиця | Юмашева улица
Юмтівський провулок | Юмтовский переулок
Юнацька вулиця | Юношеская улица
Юнацький в'їзд | Юношеский въезд
Юннатів вулиця | Юннатов улица
Юності вулиця | Юности улица
Юр'єва бульвар | Юрьева бульвар
Юри Зойфера вулиця | Юры Зойфера улица
Юридична вулиця | Юридическая улица
Юрія Кнорозова вулиця | Юрия Кнорозова улица
Юрія Кондратюка провулок | Юрия Кондратюка переулок
Юрія Лавріненка вулиця | Юрия Лавриненко улица
Юрія Паращука вулиця | Юрия Паращука улица
Юрія Шевельова вулиця | Юрия Шевелёва улица
Юр'ївська вулиця | Юрьевская улица
Юр'ївський провулок | Юрьевский переулок
Яблочкіна вулиця | Яблочкина улица
Яблочкіна провулок | Яблочкина переулок
Яблунева вулиця | Яблоневая улица
Яблуневий провулок | Яблоневый переулок
Яблуневий проїзд | Яблоневый проезд
Яблуневий в'їзд | Яблоневый въезд
Яворницького вулиця | Яворницкого улица
Ягідна вулиця | Ягодная улица
Ягідний 1-й провулок | Ягодный 1-й переулок
Ягідний 2-й провулок | Ягодный 2-й переулок
Якубівський провулок | Якубовский переулок
Якутська вулиця | Якутская улица
Якутський провулок | Якутский переулок
Ялинова вулиця | Еловая улица
Ялтинський провулок | Ялтинский переулок
Ямська вулиця | Ямская улица
Яновського в'їзд | Яновского въезд
Яновського провулок | Яновского переулок
Яновського вулиця | Яновского улица
Яремівський провулок | Еремеевский переулок
Ярова вулиця | Яровая улица
Ярослава Мудрого вулиця | Ярослава Мудрого улица
Ярослава Мудрого майдан | Ярослава Мудрого площадь
Ярославська вулиця | Ярославская улица
Ясенева вулиця | Ясеневая улица
Ясна вулиця | Ясная улица
Ясний в'їзд | Ясный въезд
Ясні Зорі вулиця | Ясные Зори улица
Ясні Зорі провулок | Ясные Зори переулок
Яснополянська вулиця | Яснополянская улица
Ячмінний провулок | Ячменный переулок
